,Unnamed: 0,證券代號,證券名稱,外陸資買進股數(不含外資自營商),外陸資賣出股數(不含外資自營商),外陸資買賣超股數(不含外資自營商),外資自營商買進股數,外資自營商賣出股數,外資自營商買賣超股數,投信買進股數,投信賣出股數,投信買賣超股數,自營商買賣超股數,自營商買進股數(自行買賣),自營商賣出股數(自行買賣),自營商買賣超股數(自行買賣),自營商買進股數(避險),自營商賣出股數(避險),自營商買賣超股數(避險),三大法人買賣超股數
0,0,00637L,元大滬深300正2  ,29741000,798000,28943000,0,0,0,0,0,0,16377469,0,0,0,33147515,16770046,16377469,45320469
1,1,2618,長榮航          ,29159524,11170000,17989524,0,0,0,10000,16321,-6321,1686289,842000,23000,819000,1566289,699000,867289,19669492
2,2,00680L,元大美債20正2   ,2465000,35000,2430000,0,0,0,0,0,0,12482140,0,250000,-250000,16786000,4053860,12732140,14912140
3,3,2883,開發金          ,17858264,3339000,14519264,0,0,0,0,23000,-23000,255000,162000,0,162000,350000,257000,93000,14751264
4,4,00665L,富邦恒生國企正2 ,21037000,3277000,17760000,0,0,0,0,0,0,-4291386,0,0,0,748287,5039673,-4291386,13468614
5,5,2486,一詮            ,13359100,2400000,10959100,0,0,0,0,1000,-1000,-222000,298000,267000,31000,138000,391000,-253000,10736100
6,6,2409,友達            ,12407650,3711000,8696650,0,0,0,0,21000,-21000,1285640,952990,278000,674990,840650,230000,610650,9961290
7,7,6213,聯茂            ,11117010,5722000,5395010,0,0,0,3683000,0,3683000,837369,978603,238000,740603,208612,111846,96766,9915379
8,8,00830,國泰費城半導體  ,4550000,155000,4395000,0,0,0,0,0,0,3984000,27000,0,27000,5571000,1614000,3957000,8379000
9,9,00688L,國泰20年美債正2 ,2780000,151000,2629000,0,0,0,0,0,0,5340974,0,0,0,7660018,2319044,5340974,7969974
10,10,2367,燿華            ,12544000,5091000,7453000,0,0,0,0,2000,-2000,479322,113000,2058,110942,877380,509000,368380,7930322
11,11,00753L,中信中國50正2   ,7458000,341000,7117000,0,0,0,0,0,0,-722864,0,0,0,436006,1158870,-722864,6394136
12,12,2888,新光金          ,8348000,2211000,6137000,0,0,0,0,0,0,133716,4716,2000,2716,131000,0,131000,6270716
13,13,6005,群益證          ,7848000,2457000,5391000,0,0,0,0,5000,-5000,0,0,0,0,0,0,0,5386000
14,14,2634,漢翔            ,7140000,3392135,3747865,0,0,0,0,1000,-1000,1480509,780000,103000,677000,988509,185000,803509,5227374
15,15,2317,鴻海            ,24512959,17562137,6950822,0,0,0,2441000,660403,1780597,-3524248,728730,2330000,-1601270,1142982,3065960,-1922978,5207171
16,16,00662,富邦NASDAQ      ,4264104,291000,3973104,0,0,0,0,0,0,1157666,16000,0,16000,1472000,330334,1141666,5130770
17,17,00893,國泰智能電動車  ,2345000,65000,2280000,0,0,0,0,0,0,2766072,0,410000,-410000,3887072,711000,3176072,5046072
18,18,2884,玉山金          ,6499245,1500874,4998371,0,0,0,0,185219,-185219,118947,68019,43000,25019,167928,74000,93928,4932099
19,19,2492,華新科          ,6623000,3987306,2635694,0,0,0,126000,1000,125000,2092723,1435368,113734,1321634,826089,55000,771089,4853417
20,20,00712,復華富時不動產  ,3159000,331000,2828000,0,0,0,0,0,0,1732480,0,0,0,2266999,534519,1732480,4560480
21,21,1314,中石化          ,4560000,403000,4157000,0,0,0,0,0,0,366000,201000,0,201000,203000,38000,165000,4523000
22,22,9904,寶成            ,7303602,3783000,3520602,0,0,0,1005000,82409,922591,-186290,25000,293290,-268290,151000,69000,82000,4256903
23,23,3706,神達            ,9441000,6370000,3071000,0,0,0,609000,15000,594000,338144,826745,456341,370404,291000,323260,-32260,4003144
24,24,6120,達運            ,4262000,652000,3610000,0,0,0,0,0,0,-2000,0,0,0,42000,44000,-2000,3608000
25,25,2337,旺宏            ,5274000,2308000,2966000,0,0,0,3000,82578,-79578,662012,303858,64000,239858,550154,128000,422154,3548434
26,26,00900,富邦特選高股息30,1918002,957000,961002,0,0,0,0,0,0,2537460,665000,15000,650000,5078912,3191452,1887460,3498462
27,27,4904,遠傳            ,4464564,1073000,3391564,0,0,0,30000,30875,-875,51274,10274,9000,1274,51000,1000,50000,3441963
28,28,1522,堤維西          ,5004900,2234150,2770750,0,0,0,0,0,0,593032,21425,4403,17022,661010,85000,576010,3363782
29,29,00902,中信電池及儲能  ,2414000,168000,2246000,0,0,0,0,0,0,1014129,0,0,0,2005952,991823,1014129,3260129
30,30,2371,大同            ,11453011,9777736,1675275,0,0,0,0,106000,-106000,1676072,1582545,184694,1397851,683220,404999,278221,3245347
31,31,3673,TPK-KY          ,3506000,530000,2976000,0,0,0,0,0,0,265871,96000,14000,82000,186871,3000,183871,3241871
32,32,3037,欣興            ,4212778,2602296,1610482,0,0,0,1419000,19464,1399536,212655,66200,74000,-7800,341271,120816,220455,3222673
33,33,00633L,富邦上証正2     ,1856000,430000,1426000,0,0,0,0,0,0,1795296,47000,0,47000,3858525,2110229,1748296,3221296
34,34,2344,華邦電          ,6002000,2808000,3194000,0,0,0,5000,3000,2000,1000,4000,174000,-170000,289000,118000,171000,3197000
35,35,2892,第一金          ,6013265,2673000,3340265,0,0,0,0,176111,-176111,17000,0,0,0,19000,2000,17000,3181154
36,36,00757,統一FANG+       ,565000,1039000,-474000,0,0,0,0,0,0,3545000,15000,0,15000,3530000,0,3530000,3071000
37,37,00895,富邦未來車      ,242000,103000,139000,0,0,0,0,0,0,2893068,0,0,0,2997000,103932,2893068,3032068
38,38,2327,國巨            ,2621100,1026000,1595100,0,0,0,511000,3505,507495,925729,599602,55407,544195,554571,173037,381534,3028324
39,39,3059,華晶科          ,4389000,2118000,2271000,0,0,0,114000,1000,113000,509394,3000,0,3000,520903,14509,506394,2893394
40,40,8033,雷虎            ,3751000,967000,2784000,0,0,0,0,0,0,63,7214,7151,63,0,0,0,2784063
41,41,1316,上曜            ,4900000,2211000,2689000,0,0,0,0,0,0,-19000,0,19000,-19000,0,0,0,2670000
42,42,2472,立隆電          ,2731000,242000,2489000,0,0,0,0,0,0,124843,30000,0,30000,95843,1000,94843,2613843
43,43,2388,威盛            ,2840300,895000,1945300,0,0,0,0,0,0,559498,491618,68982,422636,170862,34000,136862,2504798
44,44,00655L,國泰中國A50正2  ,724000,141000,583000,0,0,0,0,0,0,1870698,0,0,0,3689959,1819261,1870698,2453698
45,45,2498,宏達電          ,2259000,306000,1953000,0,0,0,278000,0,278000,147857,83946,16000,67946,92911,13000,79911,2378857
46,46,2324,仁寶            ,9348851,8714000,634851,0,0,0,0,152875,-152875,1888337,258998,492624,-233626,2514773,392810,2121963,2370313
47,47,5871,中租-KY         ,3696213,1273099,2423114,0,0,0,0,204386,-204386,3597,38000,38000,0,4597,1000,3597,2222325
48,48,8926,台汽電          ,2672000,457000,2215000,0,0,0,0,1000,-1000,1939,9714,10247,-533,2472,0,2472,2215939
49,49,5521,工信            ,3115000,874000,2241000,0,0,0,0,0,0,-62999,1,63000,-62999,0,0,0,2178001
50,50,2002,中鋼            ,5167886,2927000,2240886,0,0,0,0,141000,-141000,9000,0,0,0,9000,0,9000,2108886
51,51,00882,中信中國高股息  ,2237278,0,2237278,0,0,0,0,0,0,-158449,0,0,0,1132,159581,-158449,2078829
52,52,6550,北極星藥業-KY   ,3479000,1439000,2040000,0,0,0,0,0,0,-1804,11174,13069,-1895,91,0,91,2038196
53,53,6257,矽格            ,1069000,1398068,-329068,0,0,0,2736000,37576,2698424,-409225,29000,321000,-292000,82000,199225,-117225,1960131
54,54,5258,虹堡            ,2724000,990000,1734000,0,0,0,0,0,0,216292,39466,8103,31363,235929,51000,184929,1950292
55,55,2520,冠德            ,2612470,867000,1745470,0,0,0,0,1000,-1000,189099,136099,68000,68099,141000,20000,121000,1933569
56,56,1303,南亞            ,4957335,3768000,1189335,0,0,0,63000,53701,9299,733144,491449,30885,460564,341580,69000,272580,1931778
57,57,3715,定穎投控        ,4484000,3664300,819700,0,0,0,617000,0,617000,450224,1000,8000,-7000,491179,33955,457224,1886924
58,58,6282,康舒            ,2219000,448000,1771000,0,0,0,1000,4000,-3000,62503,16000,1920,14080,65423,17000,48423,1830503
59,59,2515,中工            ,6611000,5662000,949000,0,0,0,0,3000,-3000,865600,1333000,473000,860000,422600,417000,5600,1811600
60,60,00885,富邦越南        ,1008000,799000,209000,0,0,0,0,0,0,1566337,29000,128256,-99256,2256000,590407,1665593,1775337
61,61,2402,毅嘉            ,2574040,1564000,1010040,0,0,0,0,0,0,763299,114440,4000,110440,704959,52100,652859,1773339
62,62,2363,矽統            ,2372000,575000,1797000,0,0,0,0,0,0,-25000,0,0,0,88000,113000,-25000,1772000
63,63,6505,台塑化          ,3763216,2158000,1605216,0,0,0,73000,11172,61828,98857,105000,1390,103610,5113,9866,-4753,1765901
64,64,2020,美亞            ,1870000,199100,1670900,0,0,0,0,0,0,92245,0,4755,-4755,105000,8000,97000,1763145
65,65,2330,台積電          ,9525119,8356434,1168685,0,0,0,78000,922199,-844199,1358250,1436273,562000,874273,653171,169194,483977,1682736
66,66,2501,國建            ,1543000,289000,1254000,0,0,0,0,9000,-9000,409000,489000,80000,409000,0,0,0,1654000
67,67,6189,豐藝            ,5004000,3600000,1404000,0,0,0,0,0,0,247453,98692,85000,13692,241761,8000,233761,1651453
68,68,2504,國產            ,1795100,416508,1378592,0,0,0,0,2000,-2000,134000,134000,0,134000,0,0,0,1510592
69,69,3356,奇偶            ,2456000,973000,1483000,0,0,0,0,0,0,-591,1869,2460,-591,0,0,0,1482409
70,70,2851,中再保          ,1883000,406000,1477000,0,0,0,0,0,0,521,521,0,521,0,0,0,1477521
71,71,6116,彩晶            ,1577000,193000,1384000,0,0,0,0,0,0,55000,13000,2000,11000,50000,6000,44000,1439000
72,72,2369,菱生            ,2020000,864000,1156000,0,0,0,0,0,0,243658,4001,4,3997,240000,339,239661,1399658
73,73,00921,兆豐龍頭等權重  ,1633000,27000,1606000,0,0,0,0,0,0,-233952,66000,0,66000,944435,1244387,-299952,1372048
74,74,6197,佳必琪          ,2911000,1414000,1497000,0,0,0,0,0,0,-155020,9000,19000,-10000,45000,190020,-145020,1341980
75,75,2439,美律            ,1452000,720000,732000,0,0,0,552000,1641,550359,51489,71519,347000,-275481,328970,2000,326970,1333848
76,76,1524,耿鼎            ,4398000,3073000,1325000,0,0,0,0,0,0,-3000,5000,8000,-3000,0,0,0,1322000
77,77,9945,潤泰新          ,2321000,760000,1561000,0,0,0,0,0,0,-240000,0,256000,-256000,16000,0,16000,1321000
78,78,4915,致伸            ,3254000,1343000,1911000,0,0,0,10000,211088,-201088,-392253,2000,281691,-279691,70000,182562,-112562,1317659
79,79,2867,三商壽          ,1383200,84000,1299200,0,0,0,0,0,0,-8104,0,160000,-160000,161000,9104,151896,1291096
80,80,3045,台灣大          ,2207986,970000,1237986,0,0,0,50000,34232,15768,19321,37000,68000,-31000,63321,13000,50321,1273075
81,81,1455,集盛            ,1922000,596000,1326000,0,0,0,0,0,0,-67473,140019,207492,-67473,0,0,0,1258527
82,82,2458,義隆            ,1941000,757000,1184000,0,0,0,1000,10092,-9092,78862,32153,24291,7862,89000,18000,71000,1253770
83,83,5880,合庫金          ,3535059,2188000,1347059,0,0,0,0,158479,-158479,60000,0,0,0,60000,0,60000,1248580
84,84,2355,敬鵬            ,1509000,505000,1004000,0,0,0,0,0,0,244266,105000,0,105000,149266,10000,139266,1248266
85,85,8046,南電            ,2219020,1013000,1206020,0,0,0,0,0,0,31012,57000,76000,-19000,83428,33416,50012,1237032
86,86,2915,潤泰全          ,1266000,97000,1169000,0,0,0,0,0,0,20914,22000,2000,20000,3914,3000,914,1189914
87,87,2467,志聖            ,2104000,1008000,1096000,0,0,0,0,0,0,84361,0,639,-639,96000,11000,85000,1180361
88,88,6742,澤米            ,1102000,12290,1089710,0,0,0,60000,0,60000,-1000,0,1000,-1000,0,0,0,1148710
89,89,1217,愛之味          ,1169000,40000,1129000,0,0,0,0,0,0,-6000,0,6000,-6000,0,0,0,1123000
90,90,00770,國泰北美科技    ,224000,1000,223000,0,0,0,0,0,0,862000,0,0,0,862000,0,862000,1085000
91,91,2801,彰銀            ,2481494,1214000,1267494,0,0,0,0,171757,-171757,-21324,0,0,0,0,21324,-21324,1074413
92,92,00701,國泰股利精選30  ,385000,42000,343000,0,0,0,0,0,0,699150,45000,0,45000,1007150,353000,654150,1042150
93,93,3714,富采            ,1099000,109000,990000,0,0,0,0,0,0,11000,16000,5000,11000,0,0,0,1001000
94,94,00713,元大台灣高息低波,769061,83525,685536,0,0,0,0,238000,-238000,548170,22000,49000,-27000,825000,249830,575170,995706
95,95,1717,長興            ,1065000,110000,955000,0,0,0,0,3000,-3000,17001,1,0,1,17000,0,17000,969001
96,96,2885,元大金          ,3991521,2984726,1006795,0,0,0,0,201774,-201774,158201,151201,2000,149201,122000,113000,9000,963222
97,97,1795,美時            ,1704000,1904000,-200000,0,0,0,405000,984,404016,751733,496099,72051,424048,354685,27000,327685,955749
98,98,2547,日勝生          ,1623000,669000,954000,0,0,0,0,0,0,0,0,0,0,0,0,0,954000
99,99,2308,台達電          ,5548089,4295600,1252489,0,0,0,4000,99771,-95771,-219965,113450,166600,-53150,168000,334815,-166815,936753
100,100,3450,聯鈞            ,1727000,1027000,700000,0,0,0,0,0,0,226414,96250,5000,91250,170000,34836,135164,926414
101,101,9907,統一實          ,1186000,262000,924000,0,0,0,0,3000,-3000,0,0,0,0,0,0,0,921000
102,102,4958,臻鼎-KY         ,7511000,9100000,-1589000,0,0,0,798000,210323,587677,1902019,2290314,337741,1952573,156570,207124,-50554,900696
103,103,6288,聯嘉            ,1099000,201000,898000,0,0,0,0,0,0,-7778,0,7778,-7778,0,0,0,890222
104,104,2606,裕民            ,1288000,443000,845000,0,0,0,0,3212,-3212,34001,15001,8000,7001,56000,29000,27000,875789
105,105,1702,南僑            ,909000,81000,828000,0,0,0,0,0,0,36718,39052,2334,36718,0,0,0,864718
106,106,2889,國票金          ,2263000,1408000,855000,0,0,0,0,0,0,1000,1000,0,1000,0,0,0,856000
107,107,00648R,元大S&P500反1   ,0,0,0,0,0,0,0,0,0,846000,0,0,0,1119000,273000,846000,846000
108,108,3712,永崴投控        ,1004000,306000,698000,0,0,0,0,0,0,143000,12000,0,12000,131000,0,131000,841000
109,109,2886,兆豐金          ,5531248,3871000,1660248,0,0,0,0,716739,-716739,-106000,28000,96000,-68000,24000,62000,-38000,837509
110,110,4919,新唐            ,1210000,395000,815000,0,0,0,0,18000,-18000,40455,16000,545,15455,28000,3000,25000,837455
111,111,3622,洋華            ,2159000,1325015,833985,0,0,0,0,0,0,-1129,42000,43129,-1129,0,0,0,832856
112,112,00932,兆豐永續高息等權,306000,108000,198000,0,0,0,0,0,0,605515,0,0,0,688000,82485,605515,803515
113,113,3010,華立            ,1249000,267000,982000,0,0,0,1000,0,1000,-194000,61000,255000,-194000,0,0,0,789000
114,114,3041,揚智            ,1143000,363234,779766,0,0,0,0,0,0,0,0,0,0,0,0,0,779766
115,115,2887,台新金          ,2724000,1769000,955000,0,0,0,0,199158,-199158,18000,0,0,0,67000,49000,18000,773842
116,116,6271,同欣電          ,1065000,388000,677000,0,0,0,1000,0,1000,81022,20000,8000,12000,100164,31142,69022,759022
117,117,3056,富華新          ,1020000,274000,746000,0,0,0,0,1000,-1000,-875,9125,10000,-875,0,0,0,744125
118,118,3346,麗清            ,923000,182000,741000,0,0,0,0,2000,-2000,950,1000,50,950,0,0,0,739950
119,119,2605,新興            ,1068001,343000,725001,0,0,0,0,0,0,1426,1999,1573,426,4000,3000,1000,726427
120,120,1440,南紡            ,774000,103000,671000,0,0,0,0,0,0,52092,55000,2908,52092,0,0,0,723092
121,121,1718,中纖            ,788069,67002,721067,0,0,0,0,0,0,-2203,0,2203,-2203,0,0,0,718864
122,122,00892,富邦台灣半導體  ,507000,219000,288000,0,0,0,0,0,0,412875,78000,0,78000,1607089,1272214,334875,700875
123,123,2412,中華電          ,1359302,898000,461302,0,0,0,0,69641,-69641,304700,206700,12000,194700,110000,0,110000,696361
124,124,00642U,期元大S&P石油   ,0,18077,-18077,0,0,0,0,0,0,706975,0,0,0,987455,280480,706975,688898
125,125,2014,中鴻            ,1164000,476000,688000,0,0,0,0,0,0,-6877,7000,877,6123,3000,16000,-13000,681123
126,126,2331,精英            ,1748000,1402000,346000,0,0,0,0,1000,-1000,335747,228000,35000,193000,204816,62069,142747,680747
127,127,2457,飛宏            ,753100,330000,423100,0,0,0,0,0,0,248000,265000,18000,247000,5000,4000,1000,671100
128,128,00636,國泰中國A50     ,71000,126000,-55000,0,0,0,0,0,0,723911,100000,10000,90000,1139986,506075,633911,668911
129,129,1809,中釉            ,1366000,704000,662000,0,0,0,0,0,0,0,0,0,0,0,0,0,662000
130,130,2405,輔信            ,1287000,627000,660000,0,0,0,0,0,0,0,0,0,0,0,0,0,660000
131,131,3005,神基            ,4651000,4086082,564918,0,0,0,0,14868,-14868,108684,37041,63934,-26893,227577,92000,135577,658734
132,132,2538,基泰            ,1050000,400000,650000,0,0,0,0,0,0,0,11000,11000,0,0,0,0,650000
133,133,4306,炎洲            ,914000,270000,644000,0,0,0,0,0,0,0,0,0,0,0,0,0,644000
134,134,0061,元大寶滬深      ,115000,0,115000,0,0,0,0,0,0,526050,0,0,0,532357,6307,526050,641050
135,135,6153,嘉聯益          ,961000,295000,666000,0,0,0,0,0,0,-28000,9000,41000,-32000,4000,0,4000,638000
136,136,5471,松翰            ,790000,152000,638000,0,0,0,0,0,0,-5998,2,7000,-6998,1000,0,1000,632002
137,137,1808,潤隆            ,1225004,526000,699004,0,0,0,0,37000,-37000,-35388,20000,19709,291,2680,38359,-35679,626616
138,138,6789,采鈺            ,954000,418000,536000,0,0,0,0,40000,-40000,130496,1631,1472,159,154337,24000,130337,626496
139,139,1786,科妍            ,1104000,495000,609000,0,0,0,0,0,0,17000,50000,13000,37000,0,20000,-20000,626000
140,140,3189,景碩            ,892000,436000,456000,0,0,0,1000,19000,-18000,182691,96000,6000,90000,98691,6000,92691,620691
141,141,2539,櫻花建          ,660000,56030,603970,0,0,0,0,0,0,16000,16000,0,16000,0,0,0,619970
142,142,3058,立德            ,831654,190000,641654,0,0,0,0,0,0,-27000,0,27000,-27000,0,0,0,614654
143,143,3703,欣陸            ,718000,184000,534000,0,0,0,0,7470,-7470,87000,87000,0,87000,0,0,0,613530
144,144,3588,通嘉            ,878000,245000,633000,0,0,0,0,0,0,-20000,0,20000,-20000,0,0,0,613000
145,145,00650L,復華香港正2     ,2208000,1013000,1195000,0,0,0,0,0,0,-582071,0,0,0,1104376,1686447,-582071,612929
146,146,4961,天鈺            ,709100,543747,165353,0,0,0,302000,0,302000,140760,60000,20000,40000,112510,11750,100760,608113
147,147,2809,京城銀          ,1193000,698000,495000,0,0,0,125000,1000,124000,-15515,18419,34000,-15581,3066,3000,66,603485
148,148,2489,瑞軒            ,960001,365000,595001,0,0,0,0,0,0,1000,7000,6000,1000,0,0,0,596001
149,149,2387,精元            ,830000,187000,643000,0,0,0,0,1000,-1000,-47000,0,17000,-17000,2000,32000,-30000,595000
150,150,1802,台玻            ,1080000,568000,512000,0,0,0,0,14091,-14091,97000,47000,4000,43000,58000,4000,54000,594909
151,151,2338,光罩            ,597000,45000,552000,0,0,0,0,1000,-1000,39000,0,0,0,39000,0,39000,590000
152,152,8271,宇瞻            ,637000,63000,574000,0,0,0,0,0,0,10000,3000,0,3000,7000,0,7000,584000
153,153,2855,統一證          ,1745000,1511500,233500,0,0,0,350000,0,350000,0,0,0,0,0,0,0,583500
154,154,6835,圓裕            ,736000,152000,584000,0,0,0,0,0,0,-3000,2000,5000,-3000,0,0,0,581000
155,155,2442,新美齊          ,659000,97800,561200,0,0,0,0,0,0,13000,13000,0,13000,0,0,0,574200
156,156,2395,研華            ,847049,277076,569973,0,0,0,0,2631,-2631,2900,0,0,0,4313,1413,2900,570242
157,157,2204,中華            ,944093,402000,542093,0,0,0,0,0,0,26203,49310,6107,43203,32000,49000,-17000,568296
158,158,2464,盟立            ,2000000,1438000,562000,0,0,0,0,0,0,4923,34001,11078,22923,0,18000,-18000,566923
159,159,3049,精金            ,596000,30000,566000,0,0,0,0,0,0,0,0,0,0,0,0,0,566000
160,160,2493,揚博            ,883000,311500,571500,0,0,0,0,0,0,-7258,1000,9258,-8258,1000,0,1000,564242
161,161,3596,智易            ,789000,1352000,-563000,0,0,0,1116000,14910,1101090,22340,0,14660,-14660,82000,45000,37000,560430
162,162,00641R,富邦日本反1     ,0,0,0,0,0,0,0,0,0,557262,0,0,0,1038262,481000,557262,557262
163,163,4968,立積            ,1104000,609300,494700,0,0,0,0,0,0,59631,11421,5000,6421,75979,22769,53210,554331
164,164,6472,保瑞            ,676035,214056,461979,0,0,0,37000,0,37000,48773,34000,17000,17000,65154,33381,31773,547752
165,165,3380,明泰            ,620000,185000,435000,0,0,0,0,1000,-1000,113000,31000,6000,25000,93000,5000,88000,547000
166,166,2201,裕隆            ,719152,267000,452152,0,0,0,0,2000,-2000,95000,100000,0,100000,12000,17000,-5000,545152
167,167,00670L,富邦NASDAQ正2   ,0,15000,-15000,0,0,0,0,0,0,560111,0,0,0,651111,91000,560111,545111
168,168,2408,南亞科          ,4488000,6269000,-1781000,0,0,0,0,3550,-3550,2326321,1623000,250000,1373000,1036464,83143,953321,541771
169,169,2421,建準            ,3023000,3489500,-466500,0,0,0,1082000,3000,1079000,-73585,24484,135041,-110557,201087,164115,36972,538915
170,170,1409,新纖            ,603000,65000,538000,0,0,0,0,0,0,0,0,0,0,0,0,0,538000
171,171,1444,力麗            ,563000,22000,541000,0,0,0,0,0,0,-8789,6000,14789,-8789,0,0,0,532211
172,172,6446,藥華藥          ,672396,144000,528396,0,0,0,0,0,0,2932,4000,0,4000,7932,9000,-1068,531328
173,173,2340,台亞            ,628000,108000,520000,0,0,0,0,0,0,3002,10002,10000,2,3000,0,3000,523002
174,174,1905,華紙            ,1026000,429000,597000,0,0,0,0,0,0,-81195,34805,106000,-71195,4000,14000,-10000,515805
175,175,00850,元大臺灣ESG永續 ,171000,0,171000,0,0,0,0,0,0,343108,30000,0,30000,1010803,697695,313108,514108
176,176,00903,富邦元宇宙      ,48000,1000,47000,0,0,0,0,0,0,463695,0,0,0,1027695,564000,463695,510695
177,177,4526,東台            ,936000,429000,507000,0,0,0,0,0,0,-4367,2874,7241,-4367,0,0,0,502633
178,178,6770,力積電          ,3890000,3428000,462000,0,0,0,5000,56000,-51000,82225,6000,4000,2000,101225,21000,80225,493225
179,179,2540,愛山林          ,855000,347000,508000,0,0,0,0,0,0,-15000,5000,20000,-15000,0,0,0,493000
180,180,1305,華夏            ,690000,403000,287000,0,0,0,0,6529,-6529,209569,142000,0,142000,67569,0,67569,490040
181,181,1460,宏遠            ,522000,21096,500904,0,0,0,0,0,0,-12000,0,12000,-12000,0,0,0,488904
182,182,2836,高雄銀          ,1075000,558000,517000,0,0,0,0,0,0,-30254,11000,41254,-30254,0,0,0,486746
183,183,3033,威健            ,503000,109000,394000,0,0,0,3000,4000,-1000,93000,118000,25000,93000,0,0,0,486000
184,184,1447,力鵬            ,517000,35000,482000,0,0,0,0,0,0,1000,1000,0,1000,0,0,0,483000
185,185,6668,中揚光          ,1335000,914000,421000,0,0,0,0,0,0,60922,61000,78,60922,0,0,0,481922
186,186,8112,至上            ,1969000,1405066,563934,0,0,0,4000,122000,-118000,35247,15575,25328,-9753,63000,18000,45000,481181
187,187,2392,正崴            ,1404000,1002000,402000,0,0,0,0,1000,-1000,76000,91000,25000,66000,32000,22000,10000,477000
188,188,00692,富邦公司治理    ,106100,16000,90100,0,0,0,0,0,0,385955,33000,0,33000,1267928,914973,352955,476055
189,189,3024,憶聲            ,732000,459000,273000,0,0,0,0,0,0,201000,1000,6000,-5000,206000,0,206000,474000
190,190,00897,富邦基因免疫生技,172000,15000,157000,0,0,0,0,0,0,313975,0,0,0,1286000,972025,313975,470975
191,191,1210,大成            ,642000,159120,482880,0,0,0,0,29000,-29000,16050,50,24000,-23950,44000,4000,40000,469930
192,192,2009,第一銅          ,5069000,5086000,-17000,0,0,0,0,0,0,484275,9000,8640,360,695113,211198,483915,467275
193,193,2103,台橡            ,771750,311000,460750,0,0,0,0,0,0,94,94,0,94,0,0,0,460844
194,194,2206,三陽工業        ,668000,138026,529974,0,0,0,0,83624,-83624,9000,20000,0,20000,13000,24000,-11000,455350
195,195,00898,國泰基因免疫革命,456000,1000,455000,0,0,0,0,0,0,0,0,0,0,0,0,0,455000
196,196,2376,技嘉            ,3122758,2612507,510251,0,0,0,14000,103000,-89000,31062,404293,341985,62308,133615,164861,-31246,452313
197,197,1587,吉茂            ,1761000,1310000,451000,0,0,0,0,0,0,0,3000,3000,0,0,0,0,451000
198,198,3051,力特            ,636000,186000,450000,0,0,0,0,0,0,-2000,0,2000,-2000,0,0,0,448000
199,199,9955,佳龍            ,655000,205000,450000,0,0,0,0,0,0,-2000,0,2000,-2000,0,0,0,448000
200,200,1532,勤美            ,816000,350000,466000,0,0,0,0,1000,-1000,-19348,0,19348,-19348,0,0,0,445652
201,201,2049,上銀            ,1365089,1491000,-125911,0,0,0,590000,4931,585069,-15215,221153,207141,14012,65016,94243,-29227,443943
202,202,2393,億光            ,504000,140000,364000,0,0,0,0,7000,-7000,83195,77390,2000,75390,19000,11195,7805,440195
203,203,5434,崇越            ,367000,249000,118000,0,0,0,241000,0,241000,79866,90973,11107,79866,0,0,0,438866
204,204,2101,南港            ,825600,395000,430600,0,0,0,0,0,0,0,0,0,0,0,0,0,430600
205,205,1319,東陽            ,2074038,3312800,-1238762,0,0,0,2002000,131000,1871000,-204000,21000,185000,-164000,92000,132000,-40000,428238
206,206,2029,盛餘            ,429000,18000,411000,0,0,0,0,0,0,17092,17092,0,17092,0,0,0,428092
207,207,3437,榮創            ,520000,89000,431000,0,0,0,0,0,0,-3000,0,3000,-3000,0,0,0,428000
208,208,9939,宏全            ,491000,61000,430000,0,0,0,0,3000,-3000,-1168,9833,13001,-3168,2000,0,2000,425832
209,209,2374,佳能            ,816000,349000,467000,0,0,0,0,1000,-1000,-41000,0,41000,-41000,0,0,0,425000
210,210,2404,漢唐            ,1096000,1017145,78855,0,0,0,377000,27000,350000,-13354,42019,48000,-5981,98000,105373,-7373,415501
211,211,3209,全科            ,465000,56000,409000,0,0,0,0,0,0,5221,5221,0,5221,0,0,0,414221
212,212,3031,佰鴻            ,354000,33000,321000,0,0,0,0,0,0,91000,99000,8000,91000,0,0,0,412000
213,213,9921,巨大            ,1867000,1335000,532000,0,0,0,174000,0,174000,-298100,0,37000,-37000,57415,318515,-261100,407900
214,214,3413,京鼎            ,771000,432000,339000,0,0,0,8000,1000,7000,61325,53440,47104,6336,56493,1504,54989,407325
215,215,00934,中信成長高股息  ,2086000,497000,1589000,0,0,0,0,0,0,-1182471,0,0,0,3650219,4832690,-1182471,406529
216,216,5522,遠雄            ,634000,270000,364000,0,0,0,2000,0,2000,35840,28000,1160,26840,11000,2000,9000,401840
217,217,6873,泓德能源-創     ,396000,2000,394000,0,0,0,0,0,0,5000,5000,0,5000,0,0,0,399000
218,218,2705,六福            ,504000,136000,368000,0,0,0,0,0,0,28000,28000,0,28000,0,0,0,396000
219,219,9919,康那香          ,561000,167000,394000,0,0,0,0,0,0,-3498,0,3498,-3498,0,0,0,390502
220,220,2633,台灣高鐵        ,828000,415000,413000,0,0,0,0,27982,-27982,-1000,20000,21000,-1000,0,0,0,384018
221,221,2615,萬海            ,1194076,869000,325076,0,0,0,0,65092,-65092,116925,146000,65000,81000,46921,10996,35925,376909
222,222,3038,全台            ,452000,79000,373000,0,0,0,0,0,0,-179,1000,1179,-179,0,0,0,372821
223,223,6491,晶碩            ,672000,595000,77000,0,0,0,201000,0,201000,92475,55000,12000,43000,77255,27780,49475,370475
224,224,1515,力山            ,473000,109000,364000,0,0,0,0,0,0,2991,3001,10,2991,0,0,0,366991
225,225,2406,國碩            ,629000,275000,354000,0,0,0,0,0,0,10244,10244,0,10244,0,0,0,364244
226,226,00896,中信綠能及電動車,93000,39000,54000,0,0,0,0,0,0,309367,70000,224000,-154000,789746,326379,463367,363367
227,227,2025,千興            ,516000,158000,358000,0,0,0,0,0,0,5000,8000,3000,5000,0,0,0,363000
228,228,1909,榮成            ,513000,175000,338000,0,0,0,0,0,0,24000,26000,2000,24000,0,0,0,362000
229,229,4532,瑞智            ,580000,234000,346000,0,0,0,0,0,0,14000,14000,0,14000,0,0,0,360000
230,230,2481,強茂            ,461000,101000,360000,0,0,0,0,1000,-1000,-2403,4001,6404,-2403,0,0,0,356597
231,231,1442,名軒            ,473000,119000,354000,0,0,0,0,1000,-1000,200,200,0,200,0,0,0,353200
232,232,2228,劍麟            ,427000,102000,325000,0,0,0,0,0,0,28000,13000,0,13000,15000,0,15000,353000
233,233,4960,誠美材          ,903000,624000,279000,0,0,0,70000,0,70000,0,0,0,0,0,0,0,349000
234,234,4977,眾達-KY         ,417720,74000,343720,0,0,0,0,0,0,647,1000,353,647,0,0,0,344367
235,235,1304,台聚            ,624000,281000,343000,0,0,0,0,2000,-2000,-1862,3000,4862,-1862,0,0,0,339138
236,236,9934,成霖            ,931000,601000,330000,0,0,0,0,18347,-18347,25000,35000,10000,25000,0,0,0,336653
237,237,1402,遠東新          ,976902,446000,530902,0,0,0,0,52536,-52536,-143000,41000,86000,-45000,0,98000,-98000,335366
238,238,1734,杏輝            ,455000,121000,334000,0,0,0,0,0,0,0,0,0,0,0,0,0,334000
239,239,2399,映泰            ,431000,97000,334000,0,0,0,0,0,0,-1,0,1,-1,0,0,0,333999
240,240,6112,邁達特          ,218000,72000,146000,0,0,0,0,0,0,186147,64000,0,64000,131147,9000,122147,332147
241,241,6177,達麗            ,831000,502000,329000,0,0,0,0,0,0,3000,3000,0,3000,0,0,0,332000
242,242,2010,春源            ,468000,133000,335000,0,0,0,0,6000,-6000,1000,1000,0,1000,0,0,0,330000
243,243,2881,富邦金          ,2795324,2207868,587456,0,0,0,0,136159,-136159,-121991,0,5000,-5000,57009,174000,-116991,329306
244,244,1727,中華化          ,451000,121000,330000,0,0,0,0,0,0,-2025,929,2954,-2025,0,0,0,327975
245,245,1536,和大            ,572000,251000,321000,0,0,0,0,1000,-1000,5019,18325,13306,5019,0,0,0,325019
246,246,8222,寶一            ,1008000,743000,265000,0,0,0,0,0,0,59499,60500,1001,59499,0,0,0,324499
247,247,6743,安普新          ,386000,107000,279000,0,0,0,0,0,0,39000,35000,0,35000,4000,0,4000,318000
248,248,3055,蔚華科          ,478000,161000,317000,0,0,0,0,0,0,366,366,0,366,0,0,0,317366
249,249,2419,仲琦            ,325000,71000,254000,0,0,0,0,0,0,62000,0,0,0,63000,1000,62000,316000
250,250,5608,四維航          ,438000,154000,284000,0,0,0,0,0,0,28000,22000,4000,18000,10000,0,10000,312000
251,251,6164,華興            ,753000,442000,311000,0,0,0,0,1000,-1000,0,5000,5000,0,0,0,0,310000
252,252,8028,昇陽半導體      ,496000,187000,309000,0,0,0,0,0,0,-116,0,0,0,0,116,-116,308884
253,253,2007,燁興            ,392000,86000,306000,0,0,0,0,0,0,2000,2000,0,2000,0,0,0,308000
254,254,9946,三發地產        ,545000,232000,313000,0,0,0,0,0,0,-6000,0,6000,-6000,0,0,0,307000
255,255,00643,群益深証中小    ,4000,14000,-10000,0,0,0,0,0,0,316322,0,0,0,556684,240362,316322,306322
256,256,2534,宏盛            ,565000,237000,328000,0,0,0,0,0,0,-24000,0,24000,-24000,0,0,0,304000
257,257,3149,正達            ,323000,19000,304000,0,0,0,0,0,0,-1000,0,1000,-1000,0,0,0,303000
258,258,2109,華豐            ,365000,74000,291000,0,0,0,0,0,0,7425,10425,3000,7425,0,0,0,298425
259,259,5225,東科-KY         ,2138500,1838000,300500,0,0,0,0,0,0,-3433,10000,13433,-3433,0,0,0,297067
260,260,1102,亞泥            ,1198000,454000,744000,0,0,0,6000,517578,-511578,64075,34000,4000,30000,45075,11000,34075,296497
261,261,2913,農林            ,531000,240000,291000,0,0,0,0,0,0,3347,3000,2653,347,3000,0,3000,294347
262,262,00907,永豐優息存股    ,160000,51000,109000,0,0,0,0,0,0,184376,82000,0,82000,1150000,1047624,102376,293376
263,263,3532,台勝科          ,410000,138000,272000,0,0,0,0,0,0,20291,58000,44000,14000,11293,5002,6291,292291
264,264,1477,聚陽            ,718280,453000,265280,0,0,0,20000,0,20000,5025,30100,24177,5923,12001,12899,-898,290305
265,265,5515,建國            ,1980000,1739000,241000,0,0,0,0,2000,-2000,51000,121000,70000,51000,0,0,0,290000
266,266,1701,中化            ,187000,54000,133000,0,0,0,0,0,0,157000,157000,0,157000,0,0,0,290000
267,267,6753,龍德造船        ,226000,17000,209000,0,0,0,0,0,0,76000,0,2000,-2000,81000,3000,78000,285000
268,268,1312,國喬            ,621000,374645,246355,0,0,0,0,0,0,38000,88000,50000,38000,0,0,0,284355
269,269,1708,東鹼            ,295000,12000,283000,0,0,0,0,1000,-1000,0,0,0,0,0,0,0,282000
270,270,2312,金寶            ,437000,183000,254000,0,0,0,0,3000,-3000,29000,29000,0,29000,0,0,0,280000
271,271,2505,國揚            ,647000,369000,278000,0,0,0,0,0,0,-633,2000,2633,-633,0,0,0,277367
272,272,2379,瑞昱            ,1473703,608000,865703,0,0,0,1000,674979,-673979,83786,38080,38752,-672,137107,52649,84458,275510
273,273,1218,泰山            ,305000,76000,229000,0,0,0,0,0,0,46000,46000,0,46000,0,0,0,275000
274,274,2601,益航            ,328000,41000,287000,0,0,0,0,0,0,-14000,0,14000,-14000,0,0,0,273000
275,275,6672,騰輝電子-KY     ,383001,113000,270001,0,0,0,0,0,0,1000,1000,0,1000,0,0,0,271001
276,276,8070,長華*           ,987000,710000,277000,0,0,0,0,0,0,-6000,0,6000,-6000,0,0,0,271000
277,277,5519,隆大            ,631000,370000,261000,0,0,0,0,0,0,4000,4000,0,4000,0,0,0,265000
278,278,6669,緯穎            ,876565,585021,291544,0,0,0,0,28000,-28000,1434,43247,15518,27729,8942,35237,-26295,264978
279,279,6869,雲豹能源-創     ,309000,47000,262000,0,0,0,0,0,0,0,0,0,0,0,0,0,262000
280,280,2748,雲品            ,254000,10000,244000,0,0,0,0,0,0,14000,4000,4000,0,14000,0,14000,258000
281,281,00894,中信小資高價30  ,121000,47000,74000,0,0,0,0,0,0,183846,63000,0,63000,761656,640810,120846,257846
282,282,3047,訊舟            ,547000,290000,257000,0,0,0,0,0,0,0,0,0,0,0,0,0,257000
283,283,3338,泰碩            ,361000,95009,265991,0,0,0,0,1000,-1000,-8000,0,8000,-8000,0,0,0,256991
284,284,00683L,期元大美元指正2 ,0,2000,-2000,0,0,0,0,0,0,255090,0,0,0,255090,0,255090,253090
285,285,1760,寶齡富錦        ,394000,180000,214000,0,0,0,0,0,0,39000,0,0,0,46000,7000,39000,253000
286,286,006205,富邦上証        ,24000,3000,21000,0,0,0,0,0,0,230979,0,100000,-100000,661684,330705,330979,251979
287,287,8105,凌巨            ,320000,72000,248000,0,0,0,0,0,0,0,0,0,0,0,0,0,248000
288,288,2449,京元電子        ,4913466,4566189,347277,0,0,0,34000,62000,-28000,-71551,203000,161551,41449,101000,214000,-113000,247726
289,289,1109,信大            ,212000,29000,183000,0,0,0,0,0,0,64427,64427,0,64427,0,0,0,247427
290,290,00654R,富邦印度反1     ,0,0,0,0,0,0,0,0,0,247100,0,0,0,261100,14000,247100,247100
291,291,2453,凌群            ,384000,137000,247000,0,0,0,0,0,0,0,0,0,0,0,0,0,247000
292,292,2476,鉅祥            ,468000,331000,137000,0,0,0,0,1000,-1000,110282,6000,0,6000,114282,10000,104282,246282
293,293,2882,國泰金          ,4291193,4637216,-346023,0,0,0,741000,144753,596247,-4000,50000,0,50000,160000,214000,-54000,246224
294,294,2485,兆赫            ,328000,103000,225000,0,0,0,0,0,0,19996,11000,5004,5996,16000,2000,14000,244996
295,295,1227,佳格            ,315000,69000,246000,0,0,0,0,1000,-1000,-1000,0,1000,-1000,0,0,0,244000
296,296,2106,建大            ,417000,205000,212000,0,0,0,0,0,0,31000,31000,0,31000,0,0,0,243000
297,297,2365,昆盈            ,1403000,1158000,245000,0,0,0,0,3000,-3000,21,21,0,21,0,0,0,242021
298,298,2511,太子            ,925000,705000,220000,0,0,0,0,0,0,20000,20000,0,20000,0,0,0,240000
299,299,6442,光聖            ,1151000,922000,229000,0,0,0,0,0,0,10000,10000,0,10000,0,0,0,239000
300,300,2023,燁輝            ,282000,63000,219000,0,0,0,0,3000,-3000,22000,22000,0,22000,0,0,0,238000
301,301,2597,潤弘            ,360000,124000,236000,0,0,0,0,0,0,1862,4000,2138,1862,0,0,0,237862
302,302,6196,帆宣            ,297000,165000,132000,0,0,0,0,0,0,105168,40000,0,40000,78168,13000,65168,237168
303,303,2426,鼎元            ,246000,11000,235000,0,0,0,0,0,0,-172,0,172,-172,0,0,0,234828
304,304,4564,元翎            ,322000,88000,234000,0,0,0,0,0,0,-37,0,37,-37,0,0,0,233963
305,305,1733,五鼎            ,280000,47000,233000,0,0,0,0,1000,-1000,0,0,0,0,0,0,0,232000
306,306,3257,虹冠電          ,282000,51000,231000,0,0,0,0,0,0,0,0,0,0,0,0,0,231000
307,307,2727,王品            ,289001,79856,209145,0,0,0,42000,0,42000,-20979,0,21000,-21000,3000,2979,21,230166
308,308,8213,志超            ,195000,120000,75000,0,0,0,1000,1000,0,150127,151000,873,150127,0,0,0,225127
309,309,5533,皇鼎            ,248000,23000,225000,0,0,0,0,0,0,0,0,0,0,0,0,0,225000
310,310,5534,長虹            ,434000,377000,57000,0,0,0,53000,0,53000,110000,153000,43000,110000,0,0,0,220000
311,311,5531,鄉林            ,299000,56000,243000,0,0,0,0,0,0,-25000,0,25000,-25000,0,0,0,218000
312,312,1527,鑽全            ,287000,69000,218000,0,0,0,0,0,0,0,0,0,0,0,0,0,218000
313,313,6415,矽力*-KY        ,1710864,1509000,201864,0,0,0,1000,9428,-8428,23958,5337,4379,958,23000,0,23000,217394
314,314,8215,明基材          ,576000,356000,220000,0,0,0,0,3000,-3000,0,0,0,0,0,0,0,217000
315,315,4755,三福化          ,321000,105000,216000,0,0,0,0,0,0,-489,7000,5489,1511,1000,3000,-2000,215511
316,316,3090,日電貿          ,496000,329000,167000,0,0,0,0,1000,-1000,44112,0,354,-354,44466,0,44466,210112
317,317,1712,興農            ,276300,79000,197300,0,0,0,12000,0,12000,-71,2000,2071,-71,0,0,0,209229
318,318,1201,味全            ,268000,51000,217000,0,0,0,0,0,0,-7899,101,8000,-7899,0,0,0,209101
319,319,3266,昇陽            ,240000,23000,217000,0,0,0,0,0,0,-10000,0,10000,-10000,0,0,0,207000
320,320,2431,聯昌            ,278000,75000,203000,0,0,0,0,0,0,1000,1000,0,1000,0,0,0,204000
321,321,2484,希華            ,222000,16000,206000,0,0,0,0,0,0,-3265,1000,4265,-3265,0,0,0,202735
322,322,2104,國際中橡        ,232000,13000,219000,0,0,0,0,2000,-2000,-15000,1000,16000,-15000,0,0,0,202000
323,323,2645,長榮航太        ,335000,184000,151000,0,0,0,0,0,0,50000,45000,0,45000,13000,8000,5000,201000
324,324,2617,台航            ,326000,115000,211000,0,0,0,0,0,0,-11191,4000,15072,-11072,0,119,-119,199809
325,325,3504,揚明光          ,232000,7000,225000,0,0,0,0,0,0,-26000,0,0,0,0,26000,-26000,199000
326,326,4576,大銀微系統      ,615000,420000,195000,0,0,0,0,0,0,0,0,0,0,0,0,0,195000
327,327,3443,創意            ,541467,807020,-265553,0,0,0,134000,0,134000,326395,302088,17188,284900,61415,19920,41495,194842
328,328,2031,新光鋼          ,382100,124000,258100,0,0,0,0,1000,-1000,-63252,2000,18249,-16249,0,47003,-47003,193848
329,329,1711,永光            ,429000,237000,192000,0,0,0,0,0,0,0,0,0,0,0,0,0,192000
330,330,6531,愛普*           ,649000,721020,-72020,0,0,0,258000,1000,257000,4972,0,4000,-4000,58419,49447,8972,189952
331,331,8021,尖點            ,205000,16000,189000,0,0,0,0,0,0,-1,0,1,-1,0,0,0,188999
332,332,00911,兆豐洲際半導體  ,10050,3000,7050,0,0,0,0,0,0,181852,0,0,0,290978,109126,181852,188902
333,333,2704,國賓            ,440002,232000,208002,0,0,0,0,0,0,-20000,0,20000,-20000,0,0,0,188002
334,334,3094,聯傑            ,201000,14000,187000,0,0,0,0,0,0,0,0,0,0,0,0,0,187000
335,335,1326,台化            ,1849414,1792360,57054,0,0,0,63000,12058,50942,79000,6000,8000,-2000,82000,1000,81000,186996
336,336,1904,正隆            ,387000,208000,179000,0,0,0,0,2000,-2000,7438,8000,562,7438,0,0,0,184438
337,337,6128,上福            ,256000,74000,182000,0,0,0,0,0,0,-1,0,1,-1,0,0,0,181999
338,338,1603,華電            ,1786010,1068000,718010,0,0,0,0,0,0,-538013,3000,16000,-13000,2000,527013,-525013,179997
339,339,2427,三商電          ,267711,88000,179711,0,0,0,0,0,0,0,0,0,0,0,0,0,179711
340,340,6449,鈺邦            ,357000,179000,178000,0,0,0,0,0,0,0,0,0,0,0,0,0,178000
341,341,2495,普安            ,336000,136000,200000,0,0,0,0,0,0,-22109,1000,23109,-22109,0,0,0,177891
342,342,1416,廣豐            ,187000,19000,168000,0,0,0,0,0,0,9000,9000,0,9000,0,0,0,177000
343,343,2440,太空梭          ,234000,60000,174000,0,0,0,0,0,0,2000,2000,0,2000,0,0,0,176000
344,344,3705,永信            ,212000,84000,128000,0,0,0,0,0,0,48000,48000,0,48000,0,0,0,176000
345,345,8201,無敵            ,243000,68000,175000,0,0,0,0,0,0,0,0,0,0,0,0,0,175000
346,346,2207,和泰車          ,118000,98000,20000,0,0,0,150000,0,150000,5000,4000,1000,3000,3000,1000,2000,175000
347,347,2488,漢平            ,198000,23000,175000,0,0,0,0,0,0,-449,21000,22000,-1000,2000,1449,551,174551
348,348,6605,帝寶            ,1000000,798000,202000,0,0,0,0,0,0,-27999,10001,7000,3001,16000,47000,-31000,174001
349,349,1308,亞聚            ,333000,155000,178000,0,0,0,2000,6257,-4257,0,0,0,0,0,0,0,173743
350,350,00717,富邦美國特別股  ,204000,8000,196000,0,0,0,0,0,0,-24000,0,0,0,36000,60000,-24000,172000
351,351,2017,官田鋼          ,211000,39000,172000,0,0,0,0,0,0,0,0,0,0,0,0,0,172000
352,352,006206,元大上證50      ,38000,43000,-5000,0,0,0,0,0,0,176999,60000,0,60000,117834,835,116999,171999
353,353,1231,聯華食          ,174000,15883,158117,0,0,0,0,0,0,13000,13000,0,13000,0,0,0,171117
354,354,1104,環泥            ,285000,95000,190000,0,0,0,0,0,0,-20000,0,16000,-16000,0,4000,-4000,170000
355,355,3501,維熹            ,141000,9000,132000,0,0,0,0,0,0,38000,38000,0,38000,0,0,0,170000
356,356,6451,訊芯-KY         ,557000,427000,130000,0,0,0,0,0,0,39688,12000,12148,-148,56998,17162,39836,169688
357,357,5222,全訊            ,442200,322000,120200,0,0,0,0,0,0,46656,16000,0,16000,31656,1000,30656,166856
358,358,1309,台達化          ,197000,32000,165000,0,0,0,0,0,0,0,0,0,0,0,0,0,165000
359,359,1810,和成            ,287000,150000,137000,0,0,0,0,0,0,27000,28000,1000,27000,0,0,0,164000
360,360,2543,皇昌            ,700000,535000,165000,0,0,0,0,0,0,-1000,0,1000,-1000,0,0,0,164000
361,361,1590,亞德客-KY       ,540006,397281,142725,0,0,0,11000,440,10560,10130,19000,3000,16000,3806,9676,-5870,163415
362,362,6235,華孚            ,313000,196000,117000,0,0,0,0,0,0,45540,1000,1660,-660,47200,1000,46200,162540
363,363,00733,富邦臺灣中小    ,242100,32000,210100,0,0,0,0,0,0,-48830,19000,0,19000,386068,453898,-67830,161270
364,364,3008,大立光          ,174162,71100,103062,0,0,0,29000,2125,26875,30359,8000,1385,6615,27664,3920,23744,160296
365,365,00678,群益那斯達克生技,0,0,0,0,0,0,0,0,0,160000,0,0,0,373000,213000,160000,160000
366,366,2497,怡利電          ,173000,14000,159000,0,0,0,0,0,0,0,0,1000,-1000,1000,0,1000,159000
367,367,4770,上品            ,307000,130000,177000,0,0,0,0,12000,-12000,-6889,15000,5889,9111,9000,25000,-16000,158111
368,368,2323,中環            ,1349000,1105000,244000,0,0,0,0,0,0,-85981,19,52000,-51981,25000,59000,-34000,158019
369,369,1325,恆大            ,260000,101000,159000,0,0,0,0,0,0,-2000,0,2000,-2000,0,0,0,157000
370,370,6202,盛群            ,401000,238000,163000,0,0,0,0,5458,-5458,-708,2000,2708,-708,0,0,0,156834
371,371,00752,中信中國50      ,406000,19000,387000,0,0,0,0,0,0,-232429,0,0,0,434517,666946,-232429,154571
372,372,6782,視陽            ,407375,283000,124375,0,0,0,0,7000,-7000,36781,16000,13278,2722,52000,17941,34059,154156
373,373,1457,宜進            ,136000,12000,124000,0,0,0,0,0,0,29000,29000,0,29000,0,0,0,153000
374,374,2428,興勤            ,200000,76000,124000,0,0,0,0,1000,-1000,29521,0,479,-479,34000,4000,30000,152521
375,375,2478,大毅            ,172000,23000,149000,0,0,0,0,0,0,3000,3000,0,3000,0,0,0,152000
376,376,3535,晶彩科          ,493000,341000,152000,0,0,0,0,0,0,0,0,0,0,0,0,0,152000
377,377,00635U,期元大S&P黃金   ,111000,114000,-3000,0,0,0,0,0,0,154201,0,0,0,411964,257763,154201,151201
378,378,6277,宏正            ,19000,22000,-3000,0,0,0,0,0,0,154035,154000,0,154000,35,0,35,151035
379,379,6790,永豐實          ,161000,31000,130000,0,0,0,1000,0,1000,20000,20000,0,20000,0,0,0,151000
380,380,2038,海光            ,157000,6000,151000,0,0,0,0,0,0,-2000,0,2000,-2000,0,0,0,149000
381,381,1313,聯成            ,406000,257000,149000,0,0,0,0,0,0,0,0,0,0,0,0,0,149000
382,382,4927,泰鼎-KY         ,313000,166000,147000,0,0,0,0,0,0,998,1000,2,998,0,0,0,147998
383,383,1789,神隆            ,297000,150000,147000,0,0,0,0,0,0,27,27,0,27,0,0,0,147027
384,384,912000,晨訊科-DR       ,264000,117000,147000,0,0,0,0,0,0,0,0,0,0,0,0,0,147000
385,385,4976,佳凌            ,262001,122001,140000,0,0,0,0,0,0,6620,7000,380,6620,0,0,0,146620
386,386,2850,新產            ,244000,106000,138000,0,0,0,0,0,0,8528,16000,7472,8528,0,0,0,146528
387,387,6269,台郡            ,328000,193000,135000,0,0,0,1000,1693,-693,6528,2000,0,2000,16781,12253,4528,140835
388,388,8442,威宏-KY         ,253000,113000,140000,0,0,0,0,0,0,0,0,0,0,0,0,0,140000
389,389,8163,達方            ,285000,152000,133000,0,0,0,2000,3436,-1436,8139,21000,25861,-4861,14000,1000,13000,139703
390,390,2390,云辰            ,249001,33000,216001,0,0,0,0,0,0,-79000,0,79000,-79000,0,0,0,137001
391,391,2305,全友            ,199000,62000,137000,0,0,0,0,0,0,0,0,0,0,0,0,0,137000
392,392,9911,櫻花            ,179000,76000,103000,0,0,0,0,0,0,33000,35000,2000,33000,0,0,0,136000
393,393,3092,鴻碩            ,204000,67000,137000,0,0,0,0,0,0,-1000,0,1000,-1000,0,0,0,136000
394,394,4142,國光生          ,193000,32000,161000,0,0,0,0,1000,-1000,-24355,1000,25355,-24355,0,0,0,135645
395,395,1710,東聯            ,273000,136000,137000,0,0,0,0,2000,-2000,553,1000,447,553,0,0,0,135553
396,396,8478,東哥遊艇        ,111000,3000,108000,0,0,0,0,0,0,27346,1000,0,1000,26346,0,26346,135346
397,397,3029,零壹            ,258000,121000,137000,0,0,0,0,0,0,-2011,6000,5011,989,0,3000,-3000,134989
398,398,00728,第一金工業30    ,57000,68000,-11000,0,0,0,0,0,0,144689,40000,0,40000,316045,211356,104689,133689
399,399,3167,大量            ,154000,31000,123000,0,0,0,0,0,0,10366,12000,1634,10366,0,0,0,133366
400,400,6438,迅得            ,246000,463000,-217000,0,0,0,259000,0,259000,90056,75000,0,75000,16000,944,15056,132056
401,401,4916,事欣科          ,185000,53000,132000,0,0,0,0,0,0,0,0,0,0,0,0,0,132000
402,402,1709,和益            ,141000,11000,130000,0,0,0,0,0,0,0,0,0,0,0,0,0,130000
403,403,3576,聯合再生        ,525000,364000,161000,0,0,0,0,0,0,-31107,2000,33107,-31107,0,0,0,129893
404,404,9940,信義            ,166000,17000,149000,0,0,0,0,0,0,-19999,1,20000,-19999,0,0,0,129001
405,405,1568,倉佑            ,220000,76000,144000,0,0,0,0,0,0,-15000,1000,16000,-15000,0,0,0,129000
406,406,6670,復盛應用        ,279000,128003,150997,0,0,0,3000,0,3000,-25690,9000,34690,-25690,0,0,0,128307
407,407,2912,統一超          ,431294,308404,122890,0,0,0,0,7613,-7613,13000,14000,0,14000,0,1000,-1000,128277
408,408,3708,上緯投控        ,1005000,1085000,-80000,0,0,0,98000,2680,95320,111999,55000,11001,43999,133000,65000,68000,127319
409,409,3545,敦泰            ,1163000,1068000,95000,0,0,0,0,0,0,30042,0,0,0,30880,838,30042,125042
410,410,5243,乙盛-KY         ,269000,164000,105000,0,0,0,0,0,0,19762,103,4341,-4238,24000,0,24000,124762
411,411,00639,富邦深100       ,225000,132000,93000,0,0,0,0,0,0,30887,0,160000,-160000,491146,300259,190887,123887
412,412,5285,界霖            ,124000,3000,121000,0,0,0,0,0,0,0,0,0,0,0,0,0,121000
413,413,00646,元大S&P500      ,1000,199000,-198000,0,0,0,0,0,0,318947,23000,0,23000,409000,113053,295947,120947
414,414,00730,富邦臺灣優質高息,59000,44000,15000,0,0,0,0,0,0,105000,54000,0,54000,116000,65000,51000,120000
415,415,3019,亞光            ,347000,66000,281000,0,0,0,0,160000,-160000,-1000,2000,0,2000,0,3000,-3000,120000
416,416,1342,八貫            ,260000,145000,115000,0,0,0,0,0,0,4837,0,163,-163,7000,2000,5000,119837
417,417,1503,士電            ,873014,735000,138014,0,0,0,0,46000,-46000,27000,12000,0,12000,20000,5000,15000,119014
418,418,4571,鈞興-KY         ,174000,54000,120000,0,0,0,0,0,0,-2000,0,2000,-2000,0,0,0,118000
419,419,6209,今國光          ,224000,105000,119000,0,0,0,0,0,0,-1000,0,1000,-1000,0,0,0,118000
420,420,1604,聲寶            ,125000,7035,117965,0,0,0,0,0,0,0,0,0,0,0,0,0,117965
421,421,2423,固緯            ,129000,33000,96000,0,0,0,0,0,0,17000,19000,2000,17000,0,0,0,113000
422,422,3321,同泰            ,136001,27000,109001,0,0,0,0,0,0,1000,1000,0,1000,0,0,0,110001
423,423,4739,康普            ,135000,20000,115000,0,0,0,0,1000,-1000,-4646,0,0,0,1,4647,-4646,109354
424,424,8261,富鼎            ,183000,99000,84000,0,0,0,0,0,0,25001,0,0,0,25001,0,25001,109001
425,425,4551,智伸科          ,123000,15000,108000,0,0,0,0,0,0,1000,1000,0,1000,0,0,0,109000
426,426,2436,偉詮電          ,354000,246000,108000,0,0,0,0,1000,-1000,1022,215,193,22,5000,4000,1000,108022
427,427,6757,台灣虎航-創     ,145000,8000,137000,0,0,0,0,0,0,-29000,30000,5000,25000,73000,127000,-54000,108000
428,428,3645,達邁            ,180000,73000,107000,0,0,0,0,0,0,0,0,0,0,0,0,0,107000
429,429,6412,群電            ,296000,185000,111000,0,0,0,1000,0,1000,-5256,2000,6000,-4000,1000,2256,-1256,106744
430,430,8114,振樺電          ,116000,23000,93000,0,0,0,0,0,0,11336,10000,459,9541,2000,205,1795,104336
431,431,6715,嘉基            ,117656,22580,95076,0,0,0,0,1000,-1000,10000,0,0,0,10000,0,10000,104076
432,432,1732,毛寶            ,130000,26000,104000,0,0,0,0,0,0,0,1000,1000,0,0,0,0,104000
433,433,3006,晶豪科          ,581000,516000,65000,0,0,0,0,0,0,38992,91000,43000,48000,10681,19689,-9008,103992
434,434,1773,勝一            ,383000,275000,108000,0,0,0,0,0,0,-6000,20000,26000,-6000,0,0,0,102000
435,435,5388,中磊            ,1455074,1407000,48074,0,0,0,0,0,0,53390,79000,170610,-91610,222000,77000,145000,101464
436,436,3023,信邦            ,546000,439010,106990,0,0,0,0,4000,-4000,-1739,3000,6079,-3079,2000,660,1340,101251
437,437,2506,太設            ,173000,72000,101000,0,0,0,0,0,0,0,0,0,0,0,0,0,101000
438,438,3003,健和興          ,106000,23000,83000,0,0,0,0,0,0,16945,0,55,-55,17000,0,17000,99945
439,439,00861,元大全球未來通訊,4000,0,4000,0,0,0,0,0,0,95327,0,0,0,350327,255000,95327,99327
440,440,1721,三晃            ,153000,54000,99000,0,0,0,0,0,0,0,0,0,0,0,0,0,99000
441,441,2413,環科            ,137000,38000,99000,0,0,0,0,0,0,0,0,0,0,0,0,0,99000
442,442,2607,榮運            ,231000,128000,103000,0,0,0,0,11000,-11000,7000,8000,0,8000,0,1000,-1000,99000
443,443,1436,華友聯          ,115000,18000,97000,0,0,0,0,0,0,1000,1000,0,1000,0,0,0,98000
444,444,00901,永豐智能車供應鏈,63000,54000,9000,0,0,0,0,0,0,88685,67000,0,67000,923367,901682,21685,97685
445,445,1720,生達            ,141000,47000,94000,0,0,0,0,1000,-1000,4000,0,0,0,4000,0,4000,97000
446,446,2401,凌陽            ,612000,529000,83000,0,0,0,0,0,0,13968,9000,4433,4567,11000,1599,9401,96968
447,447,6206,飛捷            ,150000,61000,89000,0,0,0,0,0,0,7000,7000,0,7000,0,0,0,96000
448,448,3311,閎暉            ,137000,41000,96000,0,0,0,0,0,0,-452,25,477,-452,0,0,0,95548
449,449,4906,正文            ,1411000,1288000,123000,0,0,0,0,5183,-5183,-22729,4000,51416,-47416,26000,1313,24687,95088
450,450,4566,時碩工業        ,119000,23000,96000,0,0,0,0,0,0,-1000,0,1000,-1000,0,0,0,95000
451,451,1736,喬山            ,158000,58000,100000,0,0,0,0,0,0,-5107,0,4107,-4107,0,1000,-1000,94893
452,452,2637,慧洋-KY         ,1061047,708000,353047,0,0,0,0,316000,-316000,57540,12328,1751,10577,72772,25809,46963,94587
453,453,2739,寒舍            ,132000,50000,82000,0,0,0,0,0,0,12000,12000,0,12000,0,0,0,94000
454,454,9906,欣巴巴          ,115000,21000,94000,0,0,0,0,0,0,0,0,0,0,0,0,0,94000
455,455,1903,士紙            ,223000,136000,87000,0,0,0,0,0,0,6459,1459,1000,459,6000,0,6000,93459
456,456,6176,瑞儀            ,2826000,2070000,756000,0,0,0,2000,565162,-563162,-100409,60000,86000,-26000,33000,107409,-74409,92429
457,457,4540,全球傳動        ,221000,130000,91000,0,0,0,0,0,0,0,0,0,0,0,0,0,91000
458,458,4137,麗豐-KY         ,172000,98000,74000,0,0,0,0,0,0,16262,6000,0,6000,10262,0,10262,90262
459,459,3046,建碁            ,123000,33000,90000,0,0,0,0,0,0,0,0,0,0,0,0,0,90000
460,460,4414,如興            ,102000,14000,88000,0,0,0,0,0,0,0,0,0,0,0,0,0,88000
461,461,1517,利奇            ,108000,16000,92000,0,0,0,0,0,0,-4507,0,4507,-4507,0,0,0,87493
462,462,2462,良得電          ,144000,42000,102000,0,0,0,0,0,0,-18000,2000,20000,-18000,0,0,0,84000
463,463,9802,鈺齊-KY         ,71000,33000,38000,0,0,0,0,0,0,45452,1000,632,368,45484,400,45084,83452
464,464,1533,車王電          ,104000,21000,83000,0,0,0,0,0,0,0,0,0,0,0,0,0,83000
465,465,1432,大魯閣          ,127000,22000,105000,0,0,0,0,0,0,-22000,0,22000,-22000,0,0,0,83000
466,466,1324,地球            ,124000,40000,84000,0,0,0,0,0,0,-2000,0,2000,-2000,0,0,0,82000
467,467,1752,南光            ,119000,37000,82000,0,0,0,0,0,0,0,0,0,0,0,0,0,82000
468,468,2015,豐興            ,131000,51000,80000,0,0,0,0,0,0,0,0,0,0,0,0,0,80000
469,469,2022,聚亨            ,465000,624000,-159000,0,0,0,0,0,0,239000,247000,8000,239000,0,0,0,80000
470,470,3557,嘉威            ,85000,5000,80000,0,0,0,0,0,0,0,0,0,0,0,0,0,80000
471,471,1339,昭輝            ,104000,21000,83000,0,0,0,0,0,0,-4301,0,4301,-4301,0,0,0,78699
472,472,1301,台塑            ,3470821,3892920,-422099,0,0,0,0,74819,-74819,575482,327000,16000,311000,330482,66000,264482,78564
473,473,4588,玖鼎電力        ,85000,7000,78000,0,0,0,0,0,0,0,0,0,0,0,0,0,78000
474,474,6805,富世達          ,168000,75000,93000,0,0,0,2000,29000,-27000,11000,15000,4000,11000,0,0,0,77000
475,475,1453,大將            ,103000,28000,75000,0,0,0,0,0,0,2000,2000,0,2000,0,0,0,77000
476,476,1449,佳和            ,167000,37000,130000,0,0,0,0,0,0,-54000,4000,58000,-54000,0,0,0,76000
477,477,6830,汎銓            ,84000,9000,75000,0,0,0,0,0,0,1000,1000,0,1000,0,0,0,76000
478,478,1434,福懋            ,263000,182000,81000,0,0,0,0,1000,-1000,-4000,0,0,0,0,4000,-4000,76000
479,479,2342,茂矽            ,174000,99000,75000,0,0,0,0,0,0,0,0,0,0,0,0,0,75000
480,480,00714,群益道瓊美國地產,0,0,0,0,0,0,0,0,0,74199,0,0,0,274999,200800,74199,74199
481,481,4104,佳醫            ,89000,28000,61000,0,0,0,0,0,0,12718,13000,282,12718,0,0,0,73718
482,482,3583,辛耘            ,2707000,2793050,-86050,0,0,0,2000,31000,-29000,188292,83172,41607,41565,229675,82948,146727,73242
483,483,6285,啟碁            ,1069830,865000,204830,0,0,0,69000,138000,-69000,-63193,58807,67000,-8193,45000,100000,-55000,72637
484,484,6165,浪凡            ,188000,116000,72000,0,0,0,0,0,0,0,0,0,0,0,0,0,72000
485,485,6141,柏承            ,116000,43000,73000,0,0,0,0,0,0,-1000,0,1000,-1000,0,0,0,72000
486,486,6901,鑽石投資        ,190000,112000,78000,0,0,0,0,0,0,-6255,0,6000,-6000,0,255,-255,71745
487,487,4766,南寶            ,162000,91000,71000,0,0,0,0,1000,-1000,1622,0,0,0,4000,2378,1622,71622
488,488,4989,榮科            ,105000,33000,72000,0,0,0,0,0,0,-1000,0,1000,-1000,0,0,0,71000
489,489,1707,葡萄王          ,103000,38000,65000,0,0,0,0,0,0,6000,6000,0,6000,0,0,0,71000
490,490,2545,皇翔            ,71000,47000,24000,0,0,0,0,0,0,46000,46000,0,46000,0,0,0,70000
491,491,5706,鳳凰            ,94000,25300,68700,0,0,0,0,0,0,0,0,0,0,0,0,0,68700
492,492,2707,晶華            ,75000,7000,68000,0,0,0,0,1206,-1206,1072,4072,3000,1072,0,0,0,67866
493,493,2608,嘉里大榮        ,75000,8000,67000,0,0,0,0,0,0,0,0,0,0,0,0,0,67000
494,494,1713,國化            ,91000,20000,71000,0,0,0,0,0,0,-4000,0,4000,-4000,0,0,0,67000
495,495,2722,夏都            ,113000,46000,67000,0,0,0,0,0,0,-319,0,319,-319,0,0,0,66681
496,496,3515,華擎            ,173039,78000,95039,0,0,0,0,31000,-31000,1940,0,2000,-2000,7192,3252,3940,65979
497,497,2450,神腦            ,70000,5000,65000,0,0,0,0,0,0,830,1000,170,830,0,0,0,65830
498,498,3048,益登            ,114000,48000,66000,0,0,0,0,0,0,-320,2000,2320,-320,0,0,0,65680
499,499,6591,動力-KY         ,153000,91000,62000,0,0,0,0,0,0,3480,3480,0,3480,0,0,0,65480
500,500,4771,望隼            ,42000,45000,-3000,0,0,0,0,0,0,68000,68000,0,68000,0,0,0,65000
501,501,2329,華泰            ,1535000,1520000,15000,0,0,0,0,0,0,49292,33392,9184,24208,69084,44000,25084,64292
502,502,9943,好樂迪          ,77000,15000,62000,0,0,0,0,0,0,384,1000,616,384,0,0,0,62384
503,503,2461,光群雷          ,264000,218000,46000,0,0,0,0,0,0,16000,16000,0,16000,0,0,0,62000
504,504,3454,晶睿            ,76000,13000,63000,0,0,0,0,0,0,-1071,0,1071,-1071,1000,1000,0,61929
505,505,1519,華城            ,189000,130018,58982,0,0,0,0,9000,-9000,11600,18000,12000,6000,22600,17000,5600,61582
506,506,1108,幸福            ,164000,105000,59000,0,0,0,0,0,0,2000,2000,0,2000,0,0,0,61000
507,507,1310,台苯            ,127000,72000,55000,0,0,0,0,0,0,5727,6000,273,5727,0,0,0,60727
508,508,9924,福興            ,99000,63000,36000,0,0,0,0,0,0,24000,24000,0,24000,0,0,0,60000
509,509,2509,全坤建          ,69000,10000,59000,0,0,0,0,0,0,0,0,0,0,0,0,0,59000
510,510,5284,jpp-KY          ,551000,487000,64000,0,0,0,0,0,0,-6489,9000,15489,-6489,0,0,0,57511
511,511,4763,材料-KY         ,322020,300972,21048,0,0,0,0,1336,-1336,37708,16000,7000,9000,36082,7374,28708,57420
512,512,1783,和康生          ,70000,13000,57000,0,0,0,0,0,0,32,37,5,32,0,0,0,57032
513,513,2852,第一保          ,126000,70000,56000,0,0,0,0,0,0,1000,1000,0,1000,0,0,0,57000
514,514,2816,旺旺保          ,205000,159000,46000,0,0,0,0,0,0,10945,11001,56,10945,0,0,0,56945
515,515,2443,昶虹            ,57000,1000,56000,0,0,0,0,0,0,0,0,0,0,0,0,0,56000
516,516,9917,中保科          ,155008,97000,58008,0,0,0,0,1000,-1000,-1929,6000,0,6000,74,8003,-7929,55079
517,517,3308,聯德            ,107000,53000,54000,0,0,0,0,0,0,1000,1000,0,1000,0,0,0,55000
518,518,6456,GIS-KY          ,522000,477000,45000,0,0,0,0,0,0,9981,0,19,-19,12000,2000,10000,54981
519,519,00739,元大MSCI A股    ,6000,15000,-9000,0,0,0,0,0,0,63516,0,0,0,65181,1665,63516,54516
520,520,4536,拓凱            ,66000,19000,47000,0,0,0,0,0,0,7000,20000,0,20000,0,13000,-13000,54000
521,521,2929,淘帝-KY         ,62000,9000,53000,0,0,0,0,0,0,0,0,0,0,0,0,0,53000
522,522,1737,臺鹽            ,61000,8000,53000,0,0,0,0,0,0,0,0,0,0,0,0,0,53000
523,523,00710B,復華彭博非投等債,5000,2000,3000,0,0,0,0,0,0,49103,0,0,0,160000,110897,49103,52103
524,524,4956,光鋐            ,533000,477000,56000,0,0,0,0,0,0,-4000,0,4000,-4000,0,0,0,52000
525,525,1731,美吾華          ,116000,65000,51000,0,0,0,0,0,0,1000,1000,0,1000,0,0,0,52000
526,526,0055,元大MSCI金融    ,69000,17000,52000,0,0,0,0,0,0,-412,0,0,0,5999,6411,-412,51588
527,527,1540,喬福            ,93000,42000,51000,0,0,0,0,0,0,0,0,0,0,0,0,0,51000
528,528,3002,歐格            ,102000,54000,48000,0,0,0,0,0,0,3000,4000,1000,3000,0,0,0,51000
529,529,4746,台耀            ,541000,659000,-118000,0,0,0,34000,0,34000,134538,0,0,0,134539,1,134538,50538
530,530,00876,元大全球5G      ,19000,26000,-7000,0,0,0,0,0,0,56318,0,0,0,82000,25682,56318,49318
531,531,6226,光鼎            ,70000,20000,50000,0,0,0,0,0,0,-1000,0,1000,-1000,0,0,0,49000
532,532,9103,美德醫療-DR     ,49000,0,49000,0,0,0,0,0,0,0,0,0,0,0,0,0,49000
533,533,1598,岱宇            ,64000,16000,48000,0,0,0,0,0,0,4,4,0,4,0,0,0,48004
534,534,6201,亞弘電          ,73000,11000,62000,0,0,0,0,0,0,-14825,175,15000,-14825,0,0,0,47175
535,535,2332,友訊            ,257000,195000,62000,0,0,0,0,0,0,-15000,30000,0,30000,0,45000,-45000,47000
536,536,6756,威鋒電子        ,136000,63000,73000,0,0,0,0,0,0,-26014,3,170,-167,0,25847,-25847,46986
537,537,8081,致新            ,154000,103000,51000,0,0,0,1000,4000,-3000,-1544,1000,2544,-1544,0,0,0,46456
538,538,3419,譁裕            ,69000,23000,46000,0,0,0,0,0,0,0,0,0,0,0,0,0,46000
539,539,2059,川湖            ,143500,151008,-7508,0,0,0,0,9000,-9000,61995,73000,6000,67000,9265,14270,-5005,45487
540,540,1528,恩德            ,178000,133000,45000,0,0,0,0,0,0,-783,1000,1783,-783,0,0,0,44217
541,541,1417,嘉裕            ,81000,37000,44000,0,0,0,0,0,0,0,0,0,0,0,0,0,44000
542,542,2701,萬企            ,51000,7000,44000,0,0,0,0,0,0,0,0,0,0,0,0,0,44000
543,543,3305,昇貿            ,252000,199000,53000,0,0,0,0,1000,-1000,-8039,0,0,0,12000,20039,-8039,43961
544,544,4119,旭富            ,57000,14000,43000,0,0,0,0,0,0,323,1000,677,323,0,0,0,43323
545,545,00920,富邦ESG綠色電力 ,0,28000,-28000,0,0,0,0,0,0,71204,0,0,0,74204,3000,71204,43204
546,546,1617,榮星            ,140000,97000,43000,0,0,0,0,0,0,0,1000,1000,0,0,0,0,43000
547,547,9941,裕融            ,202020,156000,46020,0,0,0,0,404,-404,-2668,3000,5668,-2668,0,0,0,42948
548,548,6796,晉弘            ,67000,24000,43000,0,0,0,0,0,0,-1000,0,1000,-1000,0,0,0,42000
549,549,020030,統一智慧電動車N ,0,0,0,0,0,0,0,0,0,42000,0,0,0,47000,5000,42000,42000
550,550,00647L,元大S&P500正2   ,0,1000,-1000,0,0,0,0,0,0,43000,0,0,0,93000,50000,43000,42000
551,551,3416,融程電          ,158000,124000,34000,0,0,0,0,0,0,7995,37000,0,37000,0,29005,-29005,41995
552,552,4720,德淵            ,152000,110000,42000,0,0,0,0,0,0,-1000,2000,3000,-1000,0,0,0,41000
553,553,2482,連宇            ,95000,54000,41000,0,0,0,0,0,0,0,0,0,0,0,0,0,41000
554,554,00875,國泰網路資安    ,0,0,0,0,0,0,0,0,0,40712,0,0,0,45712,5000,40712,40712
555,555,3406,玉晶光          ,849100,780000,69100,0,0,0,0,54000,-54000,25171,114441,60663,53778,24372,52979,-28607,40271
556,556,6706,惠特            ,108000,68000,40000,0,0,0,0,0,0,0,0,0,0,0,0,0,40000
557,557,020028,元大特選電動車N ,0,0,0,0,0,0,0,0,0,40000,0,0,0,40000,0,40000,40000
558,558,6214,精誠            ,48006,52000,-3994,0,0,0,0,2391,-2391,45301,18301,0,18301,29000,2000,27000,38916
559,559,3592,瑞鼎            ,201000,163185,37815,0,0,0,0,0,0,1000,0,4000,-4000,5000,0,5000,38815
560,560,2375,凱美            ,335000,293000,42000,0,0,0,0,0,0,-3779,1006,3785,-2779,0,1000,-1000,38221
561,561,1446,宏和            ,40000,2000,38000,0,0,0,0,0,0,158,158,0,158,0,0,0,38158
562,562,6168,宏齊            ,362000,324000,38000,0,0,0,0,0,0,0,0,0,0,0,0,0,38000
563,563,3035,智原            ,1303899,1365000,-61101,0,0,0,79000,2000,77000,21967,120082,98829,21253,63301,62587,714,37866
564,564,3296,勝德            ,76000,39000,37000,0,0,0,0,1000,-1000,1000,1000,0,1000,0,0,0,37000
565,565,2364,倫飛            ,52000,15000,37000,0,0,0,0,0,0,0,0,0,0,0,0,0,37000
566,566,2243,宏旭-KY         ,46000,8000,38000,0,0,0,0,0,0,-1000,1000,2000,-1000,0,0,0,37000
567,567,9933,中鼎            ,743000,707000,36000,0,0,0,0,0,0,544,9248,8704,544,0,0,0,36544
568,568,4736,泰博            ,39000,6000,33000,0,0,0,0,0,0,3082,0,0,0,3082,0,3082,36082
569,569,6024,群益期          ,107000,71000,36000,0,0,0,0,0,0,0,0,0,0,0,0,0,36000
570,570,6541,泰福-KY         ,111000,75000,36000,0,0,0,0,0,0,0,1000,1000,0,0,0,0,36000
571,571,020032,元大綠能N       ,0,0,0,0,0,0,0,0,0,36000,0,0,0,46000,10000,36000,36000
572,572,1762,中化生          ,51000,14000,37000,0,0,0,0,0,0,-1090,0,1090,-1090,0,0,0,35910
573,573,8341,日友            ,50000,15000,35000,0,0,0,0,0,0,555,555,0,555,0,0,0,35555
574,574,2546,根基            ,61000,26000,35000,0,0,0,0,0,0,-241,0,1000,-1000,1354,595,759,34759
575,575,2348,海悅            ,188000,156000,32000,0,0,0,0,0,0,2611,12000,9389,2611,0,0,0,34611
576,576,3026,禾伸堂          ,63000,29000,34000,0,0,0,0,0,0,571,1000,429,571,0,0,0,34571
577,577,00925,新光標普電動車  ,0,0,0,0,0,0,0,0,0,34282,0,0,0,345545,311263,34282,34282
578,578,8104,錸寶            ,38000,3000,35000,0,0,0,0,0,0,-1000,0,1000,-1000,0,0,0,34000
579,579,00653L,富邦印度正2     ,4000,13000,-9000,0,0,0,0,0,0,42835,0,0,0,92353,49518,42835,33835
580,580,8039,台虹            ,114000,82000,32000,0,0,0,0,2000,-2000,3000,0,0,0,3000,0,3000,33000
581,581,6216,居易            ,69000,45000,24000,0,0,0,0,0,0,8964,9000,36,8964,0,0,0,32964
582,582,9902,台火            ,87000,54000,33000,0,0,0,0,0,0,-105,3400,3505,-105,0,0,0,32895
583,583,6515,穎崴            ,97000,48000,49000,0,0,0,0,20000,-20000,3236,0,0,0,5306,2070,3236,32236
584,584,4133,亞諾法          ,49000,15000,34000,0,0,0,0,0,0,-2000,0,2000,-2000,0,0,0,32000
585,585,00852L,國泰美國道瓊正2 ,0,0,0,0,0,0,0,0,0,31008,0,0,0,37008,6000,31008,31008
586,586,1539,巨庭            ,33000,2000,31000,0,0,0,0,0,0,0,0,0,0,0,0,0,31000
587,587,4583,台灣精銳        ,64000,60000,4000,0,0,0,0,0,0,27000,33000,6000,27000,0,0,0,31000
588,588,4108,懷特            ,35000,5000,30000,0,0,0,0,0,0,0,0,0,0,0,0,0,30000
589,589,1474,弘裕            ,36000,6000,30000,0,0,0,0,0,0,0,0,0,0,0,0,0,30000
590,590,2753,八方雲集        ,90000,101000,-11000,0,0,0,0,0,0,41000,0,0,0,41000,0,41000,30000
591,591,2616,山隆            ,44000,14000,30000,0,0,0,0,0,0,0,0,0,0,0,0,0,30000
592,592,00702,國泰標普低波高息,10000,0,10000,0,0,0,0,0,0,19000,0,0,0,120000,101000,19000,29000
593,593,3652,精聯            ,36000,9000,27000,0,0,0,0,0,0,2000,2000,0,2000,0,0,0,29000
594,594,3607,谷崧            ,101000,74000,27000,0,0,0,0,1000,-1000,2000,2000,0,2000,0,0,0,28000
595,595,1726,永記            ,29000,1012,27988,0,0,0,0,0,0,0,0,0,0,0,0,0,27988
596,596,1537,廣隆            ,47000,20000,27000,0,0,0,0,0,0,201,201,0,201,0,0,0,27201
597,597,020034,元大IC設計N     ,0,0,0,0,0,0,0,0,0,27000,0,0,0,32000,5000,27000,27000
598,598,6558,興能高          ,32000,13000,19000,0,0,0,0,0,0,7288,7288,0,7288,0,0,0,26288
599,599,2441,超豐            ,532000,500000,32000,0,0,0,0,5740,-5740,0,0,0,0,0,0,0,26260
600,600,1725,元禎            ,116000,85000,31000,0,0,0,0,0,0,-5000,0,5000,-5000,0,0,0,26000
601,601,1234,黑松            ,31000,5000,26000,0,0,0,0,0,0,0,0,0,0,0,0,0,26000
602,602,2612,中航            ,64000,38000,26000,0,0,0,0,0,0,-14,0,0,0,0,14,-14,25986
603,603,00737,國泰AI+Robo     ,12000,1000,11000,0,0,0,0,0,0,14562,0,0,0,14562,0,14562,25562
604,604,4572,駐龍            ,144100,188000,-43900,0,0,0,40000,0,40000,29000,39000,10000,29000,0,0,0,25100
605,605,5283,禾聯碩          ,29000,4000,25000,0,0,0,0,0,0,0,0,0,0,0,0,0,25000
606,606,00916,國泰全球品牌50  ,8000,1000,7000,0,0,0,0,0,0,17874,0,0,0,64000,46126,17874,24874
607,607,1220,台榮            ,14000,88000,-74000,0,0,0,0,0,0,98000,98000,0,98000,0,0,0,24000
608,608,2908,特力            ,29000,5000,24000,0,0,0,0,0,0,0,0,0,0,0,0,0,24000
609,609,6949,沛爾生醫-創     ,26000,2000,24000,0,0,0,0,0,0,0,0,0,0,0,0,0,24000
610,610,3138,耀登            ,67000,41100,25900,0,0,0,0,0,0,-2000,0,2000,-2000,0,0,0,23900
611,611,1611,中電            ,141000,132000,9000,0,0,0,0,0,0,14549,14549,0,14549,0,0,0,23549
612,612,2723,美食-KY         ,81000,55000,26000,0,0,0,0,0,0,-3000,0,11000,-11000,8000,0,8000,23000
613,613,2832,台產            ,57000,34000,23000,0,0,0,0,0,0,0,0,0,0,0,0,0,23000
614,614,6585,鼎基            ,87000,91000,-4000,0,0,0,0,0,0,27000,46000,21000,25000,2000,0,2000,23000
615,615,6863,永道-KY         ,31000,7000,24000,0,0,0,0,0,0,-1233,3000,4231,-1231,0,2,-2,22767
616,616,6115,鎰勝            ,32000,31000,1000,0,0,0,0,0,0,20512,21000,488,20512,0,0,0,21512
617,617,4106,雃博            ,16000,1000,15000,0,0,0,0,0,0,6398,7125,727,6398,0,0,0,21398
618,618,2420,新巨            ,33000,17000,16000,0,0,0,0,0,0,4000,4000,0,4000,0,0,0,20000
619,619,020031,統一IC設計臺灣N ,0,0,0,0,0,0,0,0,0,20000,0,0,0,24000,4000,20000,20000
620,620,2028,威致            ,31000,21000,10000,0,0,0,0,0,0,9000,9000,0,9000,0,0,0,19000
621,621,2107,厚生            ,45000,27000,18000,0,0,0,0,0,0,1000,1000,0,1000,0,0,0,19000
622,622,1418,東華            ,27000,9000,18000,0,0,0,0,0,0,1000,1000,0,1000,0,0,0,19000
623,623,6224,聚鼎            ,34000,15000,19000,0,0,0,0,0,0,0,0,0,0,0,0,0,19000
624,624,1506,正道            ,19000,1000,18000,0,0,0,0,0,0,0,0,0,0,0,0,0,18000
625,625,1307,三芳            ,134000,124000,10000,0,0,0,0,0,0,7000,33000,26000,7000,0,0,0,17000
626,626,3543,州巧            ,37000,20000,17000,0,0,0,0,0,0,0,0,0,0,0,0,0,17000
627,627,2380,虹光            ,17000,0,17000,0,0,0,0,0,0,0,0,0,0,0,0,0,17000
628,628,1817,凱撒衛          ,19000,2000,17000,0,0,0,0,0,0,-150,0,0,0,0,150,-150,16850
629,629,00913,兆豐台灣晶圓製造,50000,55000,-5000,0,0,0,0,0,0,21493,0,0,0,383000,361507,21493,16493
630,630,9935,慶豐富          ,26000,10000,16000,0,0,0,0,0,0,0,15000,15000,0,0,0,0,16000
631,631,5269,祥碩            ,302000,290034,11966,0,0,0,22000,32046,-10046,14037,26044,11000,15044,5955,6962,-1007,15957
632,632,3060,銘異            ,90000,12000,78000,0,0,0,0,0,0,-62508,0,62508,-62508,0,0,0,15492
633,633,4912,聯德控股-KY     ,114000,99000,15000,0,0,0,0,0,0,0,0,0,0,0,0,0,15000
634,634,911608,明輝-DR         ,15000,0,15000,0,0,0,0,0,0,0,0,0,0,0,0,0,15000
635,635,2528,皇普            ,140000,124000,16000,0,0,0,0,0,0,-1000,0,1000,-1000,0,0,0,15000
636,636,2706,第一店          ,19000,4000,15000,0,0,0,0,0,0,0,0,0,0,0,0,0,15000
637,637,2882B,國泰金乙特      ,0,0,0,0,0,0,0,0,0,15000,15000,0,15000,0,0,0,15000
638,638,6691,洋基工程        ,37000,22014,14986,0,0,0,0,0,0,0,0,0,0,0,0,0,14986
639,639,00686R,群益臺灣加權反1 ,0,0,0,0,0,0,0,0,0,14900,0,0,0,613000,598100,14900,14900
640,640,006207,復華滬深        ,1000,15000,-14000,0,0,0,0,0,0,28891,0,0,0,96466,67575,28891,14891
641,641,00693U,期街口S&P黃豆   ,17000,1000,16000,0,0,0,0,0,0,-1733,0,0,0,16267,18000,-1733,14267
642,642,6799,來頡            ,150000,145000,5000,0,0,0,0,1000,-1000,10176,0,0,0,13000,2824,10176,14176
643,643,6552,易華電          ,34000,18000,16000,0,0,0,0,0,0,-2000,0,2000,-2000,0,0,0,14000
644,644,6645,金萬林-創       ,17000,3000,14000,0,0,0,0,0,0,0,0,0,0,0,0,0,14000
645,645,2465,麗臺            ,733000,719000,14000,0,0,0,0,0,0,0,0,0,0,0,0,0,14000
646,646,4557,永新-KY         ,21000,7000,14000,0,0,0,0,0,0,0,0,0,0,0,0,0,14000
647,647,2881B,富邦金乙特      ,0,4000,-4000,0,0,0,0,0,0,18000,36000,18000,18000,0,0,0,14000
648,648,00668,國泰美國道瓊    ,0,0,0,0,0,0,0,0,0,13504,0,0,0,61565,48061,13504,13504
649,649,1219,福壽            ,64000,51000,13000,0,0,0,0,0,0,0,0,0,0,0,0,0,13000
650,650,1471,首利            ,20000,6000,14000,0,0,0,0,0,0,-1000,0,1000,-1000,0,0,0,13000
651,651,2254,巨鎧精密-創     ,14000,0,14000,0,0,0,0,0,0,-1000,0,1000,-1000,0,0,0,13000
652,652,3593,力銘            ,11000,1000,10000,0,0,0,0,0,0,3000,3000,0,3000,0,0,0,13000
653,653,9942,茂順            ,64000,47000,17000,0,0,0,0,0,0,-4000,0,4000,-4000,0,0,0,13000
654,654,8462,柏文            ,20000,4000,16000,0,0,0,0,0,0,-4000,0,4000,-4000,0,0,0,12000
655,655,6698,旭暉應材        ,65000,53000,12000,0,0,0,0,0,0,0,1000,1000,0,0,0,0,12000
656,656,8131,福懋科          ,25000,14000,11000,0,0,0,1000,0,1000,0,0,0,0,0,0,0,12000
657,657,1806,冠軍            ,12000,0,12000,0,0,0,0,0,0,0,0,0,0,0,0,0,12000
658,658,6155,鈞寶            ,72000,60000,12000,0,0,0,0,0,0,0,4000,4000,0,0,0,0,12000
659,659,6504,南六            ,13000,1000,12000,0,0,0,0,0,0,0,0,0,0,0,0,0,12000
660,660,2233,宇隆            ,30000,19000,11000,0,0,0,0,0,0,861,1000,94,906,0,45,-45,11861
661,661,3533,嘉澤            ,144027,147000,-2973,0,0,0,4000,16107,-12107,26377,23115,7015,16100,20946,10669,10277,11297
662,662,00700,富邦恒生國企    ,107000,2000,105000,0,0,0,0,0,0,-93850,0,0,0,51150,145000,-93850,11150
663,663,3653,健策            ,244000,210000,34000,0,0,0,5000,1000,4000,-27048,7958,17000,-9042,4000,22006,-18006,10952
664,664,5288,豐祥-KY         ,12000,2000,10000,0,0,0,0,0,0,791,1000,0,1000,0,209,-209,10791
665,665,2115,六暉-KY         ,11000,1000,10000,0,0,0,0,0,0,385,0,0,0,1000,615,385,10385
666,666,2069,運錩            ,3000,2000,1000,0,0,0,0,0,0,9000,9000,0,9000,0,0,0,10000
667,667,1776,展宇            ,14000,2000,12000,0,0,0,0,0,0,-2000,1000,3000,-2000,0,0,0,10000
668,668,1530,亞崴            ,16000,3000,13000,0,0,0,0,0,0,-3000,0,3000,-3000,0,0,0,10000
669,669,4581,光隆精密-KY     ,10000,0,10000,0,0,0,0,0,0,0,0,0,0,0,0,0,10000
670,670,4439,冠星-KY         ,11000,1000,10000,0,0,0,0,0,0,0,0,0,0,0,0,0,10000
671,671,1414,東和            ,47000,40000,7000,0,0,0,0,0,0,3000,3000,0,3000,0,0,0,10000
672,672,4999,鑫禾            ,12000,2000,10000,0,0,0,0,0,0,-338,0,338,-338,0,0,0,9662
673,673,2455,全新            ,2370000,1348638,1021362,0,0,0,300000,1352000,-1052000,40090,180299,192488,-12189,54279,2000,52279,9452
674,674,2891B,中信金乙特      ,0,0,0,0,0,0,0,0,0,9000,9000,0,9000,0,0,0,9000
675,675,2939,凱羿-KY         ,17000,7000,10000,0,0,0,0,0,0,-1000,0,1000,-1000,0,0,0,9000
676,676,00851,台新全球AI      ,0,0,0,0,0,0,0,0,0,9000,0,0,0,12000,3000,9000,9000
677,677,2397,友通            ,10000,1000,9000,0,0,0,0,0,0,0,0,0,0,0,0,0,9000
678,678,3022,威強電          ,76000,65000,11000,0,0,0,0,0,0,-2050,0,50,-50,0,2000,-2000,8950
679,679,3028,增你強          ,104000,59000,45000,0,0,0,0,0,0,-36422,0,36422,-36422,0,0,0,8578
680,680,9905,大華            ,41000,33000,8000,0,0,0,0,0,0,0,0,0,0,0,0,0,8000
681,681,1338,廣華-KY         ,15000,1000,14000,0,0,0,0,0,0,-6000,0,6000,-6000,0,0,0,8000
682,682,1735,日勝化          ,9000,2000,7000,0,0,0,0,0,0,1000,1000,0,1000,0,0,0,8000
683,683,2236,百達-KY         ,171000,166000,5000,0,0,0,0,0,0,3000,3000,0,3000,0,0,0,8000
684,684,6108,競國            ,79000,71000,8000,0,0,0,0,0,0,-44,0,44,-44,0,0,0,7956
685,685,4942,嘉彰            ,14000,12000,2000,0,0,0,0,0,0,5532,6000,468,5532,0,0,0,7532
686,686,00690,兆豐藍籌30      ,3000,3000,0,0,0,0,0,0,0,7230,38000,0,38000,282014,312784,-30770,7230
687,687,6278,台表科          ,579000,588000,-9000,0,0,0,93000,52000,41000,-24955,1000,18002,-17002,7047,15000,-7953,7045
688,688,5607,遠雄港          ,81000,78000,3000,0,0,0,0,1000,-1000,5000,0,0,0,7000,2000,5000,7000
689,689,9925,新保            ,33000,26000,7000,0,0,0,0,0,0,0,0,0,0,0,0,0,7000
690,690,8481,政伸            ,8000,1000,7000,0,0,0,0,0,0,0,0,0,0,0,0,0,7000
691,691,1456,怡華            ,17000,10000,7000,0,0,0,0,0,0,0,0,0,0,0,0,0,7000
692,692,5906,台南-KY         ,11000,4000,7000,0,0,0,0,0,0,0,0,0,0,0,0,0,7000
693,693,8996,高力            ,1474002,1530000,-55998,0,0,0,70000,19000,51000,11551,40301,52754,-12453,59549,35545,24004,6553
694,694,6768,志強-KY         ,22000,16000,6000,0,0,0,0,0,0,250,250,0,250,0,0,0,6250
695,695,6598,ABC-KY          ,6000,0,6000,0,0,0,0,0,0,0,0,0,0,0,0,0,6000
696,696,8162,微矽電子-創     ,6000,0,6000,0,0,0,0,0,0,0,0,0,0,0,0,0,6000
697,697,1597,直得            ,80000,73000,7000,0,0,0,0,0,0,-1000,0,1000,-1000,0,0,0,6000
698,698,6142,友勁            ,25000,19000,6000,0,0,0,0,0,0,0,0,0,0,0,0,0,6000
699,699,6426,統新            ,24000,18000,6000,0,0,0,0,0,0,0,0,0,0,0,0,0,6000
700,700,1321,大洋            ,11000,5000,6000,0,0,0,0,0,0,0,0,0,0,0,0,0,6000
701,701,2033,佳大            ,11000,5000,6000,0,0,0,0,0,0,0,0,0,0,0,0,0,6000
702,702,2712,遠雄來          ,7000,1000,6000,0,0,0,0,0,0,0,0,0,0,0,0,0,6000
703,703,2642,宅配通          ,7000,1000,6000,0,0,0,0,0,0,0,0,0,0,0,0,0,6000
704,704,0051,元大中型100     ,12000,14000,-2000,0,0,0,0,0,0,7612,15000,0,15000,0,7388,-7388,5612
705,705,6281,全國電          ,41000,35000,6000,0,0,0,0,0,0,-839,2000,2839,-839,0,0,0,5161
706,706,1558,伸興            ,15001,10000,5001,0,0,0,0,0,0,0,0,0,0,0,0,0,5001
707,707,1452,宏益            ,6000,1000,5000,0,0,0,0,0,0,0,0,0,0,0,0,0,5000
708,708,1526,日馳            ,16000,11000,5000,0,0,0,0,0,0,0,0,0,0,0,0,0,5000
709,709,2433,互盛電          ,8000,3000,5000,0,0,0,0,0,0,0,0,0,0,0,0,0,5000
710,710,2429,銘旺科          ,2000,0,2000,0,0,0,0,0,0,3000,3000,0,3000,0,0,0,5000
711,711,2496,卓越            ,9000,5000,4000,0,0,0,0,0,0,1000,1000,0,1000,0,0,0,5000
712,712,2247,汎德永業        ,5000,0,5000,0,0,0,0,0,0,0,0,0,0,0,0,0,5000
713,713,2414,精技            ,10000,5000,5000,0,0,0,0,0,0,0,0,0,0,0,0,0,5000
714,714,6525,捷敏-KY         ,10000,5000,5000,0,0,0,0,0,0,0,0,0,0,0,0,0,5000
715,715,6534,正瀚-創         ,7000,2000,5000,0,0,0,0,0,0,0,0,0,0,0,0,0,5000
716,716,6937,天虹            ,20000,15000,5000,0,0,0,0,0,0,0,0,0,0,0,0,0,5000
717,717,1315,達新            ,7000,2000,5000,0,0,0,0,0,0,0,0,0,0,0,0,0,5000
718,718,6606,建德工業        ,12000,7000,5000,0,0,0,0,0,0,0,0,0,0,0,0,0,5000
719,719,00905,FT臺灣Smart     ,63000,59000,4000,0,0,0,0,0,0,574,98000,0,98000,561000,658426,-97426,4574
720,720,3591,艾笛森          ,26000,22000,4000,0,0,0,0,0,0,26,37,11,26,0,0,0,4026
721,721,3518,柏騰            ,22000,28000,-6000,0,0,0,0,0,0,10000,10000,0,10000,0,0,0,4000
722,722,3528,安馳            ,4000,0,4000,0,0,0,0,0,0,0,0,0,0,0,0,0,4000
723,723,3054,立萬利          ,4000,0,4000,0,0,0,0,0,0,0,1000,1000,0,0,0,0,4000
724,724,6573,虹揚-KY         ,8000,2000,6000,0,0,0,0,0,0,-2000,0,2000,-2000,0,0,0,4000
725,725,8438,昶昕            ,4000,1000,3000,0,0,0,0,0,0,1000,4000,3000,1000,0,0,0,4000
726,726,910861,神州-DR         ,4000,0,4000,0,0,0,0,0,0,0,0,0,0,0,0,0,4000
727,727,9912,偉聯            ,8000,2000,6000,0,0,0,0,0,0,-2000,0,2000,-2000,0,0,0,4000
728,728,9928,中視            ,0,0,0,0,0,0,0,0,0,4000,4000,0,4000,0,0,0,4000
729,729,1423,利華            ,6000,2000,4000,0,0,0,0,0,0,0,0,0,0,0,0,0,4000
730,730,1101B,台泥乙特        ,0,0,0,0,0,0,0,0,0,4000,4000,0,4000,0,0,0,4000
731,731,4967,十銓            ,234000,255000,-21000,0,0,0,0,0,0,24412,25000,588,24412,0,0,0,3412
732,732,6183,關貿            ,6000,4000,2000,0,0,0,0,0,0,1386,2000,0,2000,0,614,-614,3386
733,733,8443,阿瘦            ,6000,2000,4000,0,0,0,0,0,0,-902,98,1000,-902,0,0,0,3098
734,734,1110,東泥            ,11000,6000,5000,0,0,0,0,0,0,-2000,0,2000,-2000,0,0,0,3000
735,735,4722,國精化          ,10000,7000,3000,0,0,0,0,0,0,0,0,0,0,0,0,0,3000
736,736,4737,華廣            ,8000,5000,3000,0,0,0,0,0,0,0,0,0,0,0,0,0,3000
737,737,4440,宜新實業        ,1000,1000,0,0,0,0,0,0,0,3000,3000,0,3000,0,0,0,3000
738,738,4560,強信-KY         ,68000,65000,3000,0,0,0,0,0,0,0,0,0,0,0,0,0,3000
739,739,1454,台富            ,4000,1000,3000,0,0,0,0,0,0,0,0,0,0,0,0,0,3000
740,740,00736,國泰新興市場    ,24000,0,24000,0,0,0,0,0,0,-21000,0,0,0,100000,121000,-21000,3000
741,741,006203,元大MSCI台灣    ,0,0,0,0,0,0,0,0,0,3000,0,0,0,4000,1000,3000,3000
742,742,2466,冠西電          ,3000,0,3000,0,0,0,0,0,0,0,0,0,0,0,0,0,3000
743,743,2901,欣欣            ,4000,1000,3000,0,0,0,0,0,0,0,0,0,0,0,0,0,3000
744,744,1340,勝悅-KY         ,19000,12000,7000,0,0,0,0,0,0,-4478,7000,11478,-4478,0,0,0,2522
745,745,00663L,國泰臺灣加權正2 ,0,1000,-1000,0,0,0,0,0,0,3190,0,0,0,4190,1000,3190,2190
746,746,1439,雋揚            ,11000,10000,1000,0,0,0,0,0,0,1000,1000,0,1000,0,0,0,2000
747,747,1256,鮮活果汁-KY     ,4000,1000,3000,0,0,0,0,0,0,-1000,0,1000,-1000,0,0,0,2000
748,748,1466,聚隆            ,8000,6000,2000,0,0,0,0,0,0,0,0,0,0,0,0,0,2000
749,749,2904,匯僑            ,4000,2000,2000,0,0,0,0,0,0,0,0,0,0,0,0,0,2000
750,750,4438,廣越            ,4000,2000,2000,0,0,0,0,0,0,0,0,0,0,0,0,0,2000
751,751,1323,永裕            ,1000,0,1000,0,0,0,0,0,0,1000,1000,0,1000,0,0,0,2000
752,752,5203,訊連            ,26000,14000,12000,0,0,0,0,0,0,-10000,1000,0,1000,0,11000,-11000,2000
753,753,8488,吉源-KY         ,6000,5000,1000,0,0,0,0,0,0,1000,1000,0,1000,0,0,0,2000
754,754,2891C,中信金丙特      ,0,0,0,0,0,0,0,0,0,2000,2000,0,2000,0,0,0,2000
755,755,8249,菱光            ,7000,5000,2000,0,0,0,0,0,0,-178,822,1000,-178,0,0,0,1822
756,756,1906,寶隆            ,5000,4000,1000,0,0,0,0,0,0,426,2000,1574,426,0,0,0,1426
757,757,6582,申豐            ,4000,3000,1000,0,0,0,0,0,0,265,265,0,265,0,0,0,1265
758,758,2432,倚天酷碁-創     ,0,2000,-2000,0,0,0,0,0,0,3000,0,0,0,3000,0,3000,1000
759,759,8482,商億-KY         ,0,1000,-1000,0,0,0,0,0,0,2000,2000,0,2000,0,0,0,1000
760,760,9944,新麗            ,13000,12000,1000,0,0,0,0,0,0,0,0,0,0,0,0,0,1000
761,761,9110,越南控-DR       ,3000,2000,1000,0,0,0,0,0,0,0,0,0,0,0,0,0,1000
762,762,8072,陞泰            ,6000,5000,1000,0,0,0,0,0,0,0,0,0,0,0,0,0,1000
763,763,6792,詠業            ,6000,5000,1000,0,0,0,0,0,0,0,0,0,0,0,0,0,1000
764,764,6916,華凌            ,1000,0,1000,0,0,0,0,0,0,0,0,0,0,0,0,0,1000
765,765,6861,睿生光電        ,2000,1000,1000,0,0,0,0,0,0,0,0,0,0,0,0,0,1000
766,766,3040,遠見            ,3000,2000,1000,0,0,0,0,0,0,0,0,0,0,0,0,0,1000
767,767,2424,隴華            ,1000,0,1000,0,0,0,0,0,0,0,0,0,0,0,0,0,1000
768,768,2945,三商家購        ,3000,2000,1000,0,0,0,0,0,0,0,0,0,0,0,0,0,1000
769,769,2910,統領            ,0,3000,-3000,0,0,0,0,0,0,4000,4000,0,4000,0,0,0,1000
770,770,1213,大飲            ,1000,0,1000,0,0,0,0,0,0,0,0,0,0,0,0,0,1000
771,771,1419,新紡            ,2000,1000,1000,0,0,0,0,0,0,0,0,0,0,0,0,0,1000
772,772,00666R,富邦恒生國企反1 ,0,2000,-2000,0,0,0,0,0,0,3000,0,0,0,323000,320000,3000,1000
773,773,020036,元大金融配息N   ,0,0,0,0,0,0,0,0,0,1000,0,0,0,2000,1000,1000,1000
774,774,020002,元富新中國N     ,0,0,0,0,0,0,0,0,0,1000,0,0,0,1000,0,1000,1000
775,775,2351,順德            ,210000,209000,1000,0,0,0,0,0,0,-70,0,0,0,2000,2070,-70,930
776,776,6526,達發            ,55000,48000,7000,0,0,0,0,7000,-7000,696,1000,0,1000,4000,4304,-304,696
777,777,1589,永冠-KY         ,138000,81000,57000,0,0,0,0,0,0,-56794,2000,2226,-226,0,56568,-56568,206
778,778,9918,欣天然          ,1,0,1,0,0,0,0,0,0,0,0,0,0,0,0,0,1
